auf	- on<div>-&nbsp;dative if no movement, accusative with movement/direction<br /><div>-use with open spaces (e.g., streets, terraces, but not parks, gardens, and forests — use in), islands, public areas (e.g., bank, market), events like parties, with the word “page” (Seite)</div></div><div>- aufs</div>
auf jeden Fall	“in any case”
absetzen auf	to set down on
achtgeben auf	to look out for
anstoßen auf	to toast for
antworten auf	to reply to
ausweisen auf	to expel from
sich freuen auf	to be happy about
warten auf	"1) to wait for (""Ich werde auf sie warten."")"
zielen auf	to aim for
zuschießen auf	to hurdle toward, to pounce on
einschließlich	including
der Vogel	1) the bird (Ich sehen einen grünen Vogel.)
an	locative — “next to / on / in / by” — dative
die Besprechung	the meeting
das Schach	chess (no plural form)
der Feiertag	the holiday (die Feiertage)
der Geburtstag	the birthday (die Geburstage) (“Mein Geburstag ist morgen”)
adaptieren an	to adapt to
akklimatisieren an	to acclimatize to
andrücken an	to tighten against
anschließen an	to connect to
anstoßen an	to strike against
denken an	to think about
sich erinnern an	to remember
glauben an	to believe in (accusative!)
grenzen an	to border with
schicken an	to send to
anschreiben	1) to write to someone, especially in mail ()<div>2) to be on the slate ()</div><div><br /></div><div>pret: schrieb an</div><div>part: angeschrieben</div>
vorbeimarschieren an	to parade before
zweifeln an	1) to doubt<div><br /></div><div>pret: zweifelte an</div><div>part: anzweifelte</div>
an contractions	am, ans
Ihre Eltern (nominative)	her (if uncapitalized)/their (if uncapitalized)/your (singluar/plural formal, if capitalized) parents
der Patient	<div>die Patienten</div>1) the patient (Der Patient braucht ein Bein.)
bluten	1) to bleed (Mein Bein blutet! &nbsp;Brauche ein Artz!)
der Unfall	the accident/the crash/the casualty (die Unfälle)
der Notfall	the emergency/the distress/the exigency (die Notfälle)
die Ernährung	the diet (usual food)/the nutrition/the nourishment (no plural listed)
die Untersuchung	the study/the investigation/the scrutiny/the examination (die Untersuchungen)
die Therapie	<div>(die Therapien)</div>1) the therapy (Die Therapie hiflt ihm.)
das Opfer	<div>(die Opfer)</div>1) the sacrifice<div>2) the victim</div><div>3) the casualty</div>
die Krankenversicherung	the health insurance (die Krankenversicherungen)
die Liebe	the love/the affection (die Lieben)
der Wunsch	<div>(die Wünche)</div>1) the wish (Ich hat keinen Wunsch.)
der Traum	the dream (die Träume)
die Lust	the lust (die Lüste)
Er hat keine Lust	“he can’t be bothered”/“he does not want to”
die Not	"<div>(die Nöte)</div>1) the distress/hardship (""Meine Not ist echt."")"
träumen	1) to dream<div><br /></div><div>pret: träumte</div><div>part: geträumt</div>
die Freude	<div>(die Freuden)</div>1) the joy (Die Frau hat Freude.)
der Spaß	<div>(die Späse)</div>1) the fun<div>2)&nbsp;the spree</div><div>3) the jest/the joke</div><!--anki-->
lieben	to love
die Angst	<div>die Ängste</div>1) the fear<div>2) anxiety</div>
der Ernst	the seriousness/gravity
Es ist mein Ernst	“I am serious”
unheimlich	"1) scary/eerie/uncanny (""Das ist unheimlich suß."")"
das Verständis	the insight/appreciation
interessant	interesting
langweilig	boring/bored
“Die Ente ist langweilig” vs “Der Ente ist langweilig”	“the duck is boring” vs “the duck is bored”
die Ruhe	the rest/quiet/calmness (“Sonntag ist ein Tag der Ruhe”)
hassen	to hate [a noun]
der Witz	the joke (die Witze)
der Gedanke	<div>(die Gedanken)</div>1) the thought<div>2) the idea</div>
der Verkehr	the traffic
Die Familie macht Urlaub	“The family is on vacation”
funktionieren	1) to behave ()<div>2) to operate/to function ()</div><div><br /></div><div>pret: funktionierte</div><div>part: funkioniert</div>
nihmen zu	to increase
steigen	1) to rise/increase/climb<div><br /></div><div>pret: steig</div><div>part: gestiegen</div>
benutzen	1) to use (Ich muss dieses motorrad benutzen.)<div><br /><div>pret: benutzte</div><div>part: benutzt</div></div>
treffen	"1) to meet (""Ich werde um zwei Uhr mit Ihnen treffen."")<div>2) to hit/to strike</div><div>3) to score<br /><div><br /></div><div>pres: ich treffe / du triffst / etw. trifft / wir treffen / ihr trefft / sie treffen</div><div>pret: traf</div><div>part: getroffen</div><div>imper: treffe / trefft (pl)</div><div>kon1: treffe</div><div>kon2: träfe</div></div>"
der Nachbarn	the neighbor (die Narchbarn)
bestellen	"1) to order (as food) (""Was bestellen wir im Resutaruant?"")<div>2) to book (as hotel)</div><div><br /></div><div>pret: bestellte</div><div>part: bestellt</div>"
möchten	1) to want something politely (would like)<div><br /></div><div><br /></div>
das Glas / die Gläser	the glass (cup)
ersetzen	"1) to replace/supersede (""Ich kann ihn ersetzen."")<div>2) to reimburse</div><div><br /></div><div>pret: ersetzte</div><div>part: ersetzt</div>"
nehme	to take/adopt/use
der Bein	1) the leg (Ich habe mein Bein verletzt.)
fehlen	"1) to lack/miss (""Die Antwort Fehlt"")<div>2) to err/to sin</div><div><br /></div><div>pret: fehlte</div><div>part: gefehlt</div>"
wen	whom (accusative)
wer	who (nominative)
wem	whom (dative)
wessen	whose (genetive)
das Baby	the baby
nur	only (“Es dauert nur einen Augenblick”)
ihn	him (dative)
werden	"1) [to] will (verb) (""Ich werde euch gehen."") (Die Suppe ist kalt geworden.)<div><br /></div><div>pret: wurde / ward</div><div>perf: geworden</div><div>kon1: werde</div><div>kon2: würde</div>"
rufen	"1) to call (""Ich werden ihn rufen."")<div>2) cry/shout</div>"
“In ein paar Tagen wird es dir besser gehen”	“It will be better for you in a couple days”
die Heimat	<div>(die Heimaten)</div>1) the homeland (no literal translation)
die Sehenswürdigkeiten	the sights (see-worthy things)
testen	to test/examine
bieten	to offer/provide (dative)
vergessen	1) to forget (Er hat der Termin vergessen.) &nbsp;(Ich vergesse nie meinen Schlüssel.)<div><br /></div><div>pres: ich vergesse / du vergisst,vergißt / etw. vergisst,vergißt / wir vergessen / ihr vergesst,vergeßt / sie vergessen</div><div>pret: vergaß</div><div>part: vergessen</div><div>imper: vergiss,vergiß / vergesst,vergeßt (pl)</div><div>kon1: vergesse</div><div>kon2: vergäße</div>
merken	to notice/remember
bald	"soon (""Du wirst die Stadt bald lieben."")"
der Arzt / die Ärztin	"<div>(die Ärzte / die Ärztinnen)</div>1) the doctor (""Ich bin krank."" ""Ich werde den Artz rufen."")"
reden	"1) to speak/talk (mit, dative) (""Ich will mit ihm reden."")"
hier	here
da	"1) here/there (""Was liegt da?"")"
dort	there
drüben	1) over there (as in ‘Der Apfel da/dort druben ist Groß’)
hinten	behind/towards the back (‘Hinten im Garten sind rote Blumen’)
drinnen	inside
überall	1) everywhere (‘In Deutschland sind sie überall’) (Die Tierwelt ist überall.)
neben	next to / beside (dative prep)
nebenan	next door/place/room (‘Wer ist nebenan?’)
draußen	outside (‘Er spielt draußen’)
unten	down/under/below (‘Wir sind unten’)
oben	above/upsatirs (‘Mein Vater ist oben’)
entweder	either
ehrlich	honest/faithfully/sincere
schlau	smart/shrewd/clever
lieber	rather/prefer (adv) (‘Ich mag Katze lieber’ or ‘Ich mag lieber Katze’)
witzig	witty/humorous/funny
lustig	funny/hilarious/merry/jolly
dumm	stupid/silly/foolish/dumb
der Ärger	anger/resentment/irritation (no plural)
der Liebling	favorite/darling/sweetums/honey (die Lieblinge)
stolz	1) proud<div>2) tidy</div>
nett	nice/kind/cute
total	totally/really/extremely
böse	1) vicious/wicked/evil
verärgert	angry/upset
lachen	to laugh
das Lachen	the laughter
das Glück	1) the fortune/luck
zum Glück	“with luck”/“luckily”
tapfer	"1) brave/valiant/bold (""Ich könnte nicht das machen. &nbsp;Du bist tapfer."")"
schlimm	bad/severe/sad/likely nothing good will ever come out of it
gar	done/fully cooked
gar nicht	“not at all”
gar nichts	“none whatsoever”
der Liter	the liter
hundertdreiundzwanzig	123
die Antwort	1) the answer (Mehr Fragen als Antworten.)
die Frage	the question
wohnen	1) to live (somewhere)<div><br /></div><div>pret: wohnte</div><div>part: gewohnt</div>
die Hauptstadt	the capital city
Europa	Europe
die Umgebung	1) the environment/vicinity/surroundings
der Flughafen	the airport (die Flughäfen)
der Standort	the site/location (die Standorte)
gegenüber	opposite/towards (dative)
die Pension	"<div>die Pensionen</div>1) the pension<div>2) the retirement</div><div>3) the guest house (""Die Pension hat keine Stühle."")</div>"
zusammen	together/altogether
der Lehrer / die Lehrerin	the teacher (die Lehrer / die Lehrerin; gen — Lehrers)
der Stuhl	the chair (die Stühle)
grün	green
jetzt	"1) now (""Wir werden jetzt darüber sprechen."")"
morgen	tomorrow (adv)
heute	1) today (adv) (“Wirst du heute mit uns zu Mittag essen?”)
einkaufen	to shop
der Termin	1) the appointment (die Termine) (Ich habe einen Termin am zwei.)
dann	1) then/next ()
persönlich	1) personal/private
der Moment	the moment (die Momente)
“Ich bin nicht von gestern”	“I was not born yesterday”
gestern	yesterday
früh	"early/soon (“Wie früh?”) (""Es ist früh."")"
aufstehen	to rise (get up)
das Aufstehen	the rising (getting up)
spät	late (“Früh, nicht spät” / “Bis später!”)
die Nacht	the night (die Nächte) (“Die Fahrt dauert sechs Tage und fünf Nächte”)
der Abend	the evening (die Abende)
arbeiten	"1) to work/labor (""Er arbeitet kaum."")<div><br /></div><div>pret: arbeitete</div><div>part: gearbeitet</div>"
der Zeitraum	1) the period/stretch of time (die Zeiträume)
schwach	"1) weak/faint/feeble (""Mein Herz ist schwach."")"
das Schwarz	1) the color black<div><br /></div><div>(adj) black (Das ist schwarz.)</div>
bis	"1) until/to (“Jährlich von Juni bis August”) (""Ich werde bis fünf zählen."")"
der Juni	June (die Junis)
der August	August (die Auguste)
“am Morgen”	“in the morning” (because an + [a time] = ‘in the time’)
ruhig	calm/quiet/still
die Uhr	1) the clock/timepiece (die Uhren) (Sie hat ihm eine Uhr gegeben.)
die Minute	"1) the minute (die Minuten) (""Die Untersuchung dauert wenige Minuten."")"
die Sekunde	"<div>(die Sekunden)</div>1) the second (""Neun Sekunden?"")"
die Zeit	1) the time (die Zeiten) (Ich habe keine Zeit für dich.)
der Augenblick	the instant/moment/flash/the glimpse of an eye (die Augenblicke)
“einen Augenblick Zeit”	“a short/spare moment”
das Auge	<div>(die Augen)</div>1) the eye ()
der Blick	<div>(die Blicke)</div>1) the glimpse/glance/sight&nbsp;
die Uhrzeit	<div>(die Uhrzeiten)</div>1) the time (of day)
später	1) later (Jetzt, fünf Jahre später, lesen wir es erneut.)
die Stunde	the hour (die Stunden)
dauert	lasts (“Das dauert” = “That takes a while”)
“Das dauert”	“That takes a while” (literal — “that lasts”)
das Viertel	<div>die Viertel</div>1) the quarter (as in 25%)
“Es ist viertel vor sechs”	“It is a quarter before six”
sofort	1) immediately/instantly/immediate (“Der Zug kommt sofort”)
nachts	nights/at night (“Du liest nachts” / also “Du liest bei Nachts”)
der Zeitpunkt	<div>(die Zeitpunkte)</div>1) the moment/point in time (“Ich werde zu diesem Zeitpunkt nicht da sein”)
offen	open/candid/free (“Der Zeitpunkt ist offen”)
halb	half (“Wir kommen um halb zwei”)
die Küche	the kitchen (die Küchen)
der Zimmer	the room (die Zimmer)
“Es ist zwölf Uhr fünfunddreißig”	“It is twelve thirty-five”
“Es ist fünf nach halb eins”	“It is twelve thirty-five”
bleiben	"1) to remain/to stay (""Ich bliebe hier."") (""Ich bleibe nicht lange.)<div><br /></div><div>pret: blieb</div><div>part: geblieben / blieben</div>"
lange	long (adverb ('for long') (“Ich bleibe nicht lange”)
gerade	1) even/just now/straight (“Ich habe gerade keine Zeit” / “I don’t have time right now”) (Ich bin gerade gekommen.)
fast	"1) almost/nearly (""Es ist fast elf Uhr."")"
etwa	"1) about/approximately (“Das Pferd frisst etwa zehn Äpfel.”) (""Die Tour dauert etwa vier Stunden.) (""Wir kommen um etwa sieben Urh."")"
das Pferd	1) the horse (die Pferde)
der Apfel	<div>(die Äpfel)</div>1) the apple
“Wie spät ist es gerade?”	“How late is it just now / What time is it now?”
der Juli	July (die Julis)
damals	"1) then/back then/at that time (“Damals und heute” = “then and now”; (""Genauso wie damals?"")"
die Dauer	the duration/period (die Dauern)
“Wie viel Uhr ist es?”	“How much clock is it? / How late is it?”
der Januar	January (die Januare)
der Herbst	autumn (die Herbste)
kühl	chilly / cool
der Gebertstag	the birthday (die Gebertstage)
das Datum	the date (calendar) (die Daten)
die Phase	the phase (die Phasen)
die Jahrzseit	the season (die Jarhzeiten)
der Schluss	<div>&nbsp;(die Schlüsse)</div>1) the conclusion/the end (Es ist Schluss mit uns!)
sinvoll	sensible/useful/meaningful
der September	die September
der Oktober	October (die Oktober)
die Saison	the season (die Saisons)
das Alter	age (of a person) (die Alter)
der Frühling	Spring (die Frühlinge)
jährlich	yearly
der Kalender	calendar (die Kalender)
der Dezember	December (die Dezember)
öffnen	1) to open<div>2) to undo/to unclench</div>
die Flasche	the bottle (die Flaschen)
das Bad	the bath (die Bäder)
der Rasierer	the razor (die Razierer)
brauchen	1) to need/to require (Ich brauche mehr Geld.)<div><br /></div><div>pret: brauchte</div><div>part: gebraucht</div><div>kon1: brauche</div><div>kon2: bräuchte</div>
der Haushalt	the household/the budget (die Haushalte)
bezahlen	1) to pay/to disburse (Ich kann nicht für euch bezahlen.)<div><br /></div><div>pret: bezahlte</div><div>part: bezahlt</div>
zählen	"1) to count/to reckon/to clock/to rank/to total (“Er zählt die Stunden”) (""Ich werde bis fünf zählen."")"
die Seife	the soap (die Seifen)
die Schüssel	the bow (die Schüsseln)
der Spiegel	1) the mirror (die Spiegel)
die Reinigung	the purification/the cleansing/the cleaning (die Reinigungen)
teuer	expensive/costly
die Leiter	<div>(die Leitern)</div>1) the ladder<div>2)&nbsp;the conductor</div>
der Karton	the cardboard (die Kartons)
langsam	slow
das Duschgel	the bodywash (die Duschgele)
noch	"1) still/yet/as yet (Wir haben noch nie gesprochen.)<div>2) nor (""Er ist weder hier noch da."")</div><div><br /></div><div>(also used in phrases)&nbsp;</div>"
“noch eine Flasche, bitte”	“another bottle, please”
leer	empty/devoid/flat
mehr	more/further (“Meine Mutter schwimmt mehr als mein Vater”)
das Geschäft	the shop/the business/the deal (die Geschäfte)
das Geld	the money (die Gelder)
schlafen	1) to sleep<div><br /></div><div>sclief</div><div>geschlafen</div>
wenig	"1) few (""Wir haben weniger als sechs Minuten."")<div>NOTE: exception to inflection; only has comparative ending -er but no case or number ending (""Er hat weniger Reis"", not ""Er hat wenigeren Reis."")</div>"
der Teller	"the plate (die Teller) (""Die Küche hat wenig Teller."")"
das Messer	the knife (die Messer)
der Löffel	the spoon (die Löffel)
die Gabel	the fork (die Gabeln)
als	"1) than&nbsp;(“Eins ist weniger als zwei”)<div>2) as/when (""Er arbeitet außerdem als Autor."")</div>"
stark	strong
oft	1) often/frequently (“Ich laufe oft”)
kochen	1) to cook/to boil (“Wie oft kochst du?”) (Er hat gekocht!)<div><br /></div><div>pret: kochte</div><div>part: gekocht</div>
manchmal	"1) sometimes (“Manchmal Ich laufe…”; ""Manchmal ist er hilfreich"")&nbsp;"
fit	fit (in shape)
selten	rarely/seldom/rare/scarce (“Ich bin selten im Winter fit”)
der Winter	winter (die Winter)
letzte	"1) latter/last/final (""Nicht das letzte Mal."") (""Das ist die letzte Stunde des Tages."")"
das Mal	<div>(die Male)</div>1) the time (Das fünfte Mal.)
“Mal schauen was wir noch haben”	“Let’s see what we still have” (think “Time to eat”)
groß	big (“Es gibt kein großeres Schloss”)
häufig	often/common/frequently/frequent/abundant
zahlreich	1) a range of/numerous/legion (“Du hast zahlreiche Werkzeuge”)
das Werkzeug	the tool/the implement (die Werkzeuge)
das Bisschen	"<div>(die Bisschen)</div>1) the mite (very small amount / a little bit) (""Wir lesen ein bisschen."")"
je	"1) each (short for 'jemals') (""Je mehr, desto besser."")<div>2) ever</div>"
“Je größer, je stärker”	“The bigger, the stronger”
ob	whether/if (“Ich weiß nicht, ob sie wartet”)
wissen	to know (“Ich weiß das!”)
meist	mostly/usually/most (“Wir kennen die meisten Nachbarn” / “Meist mag ich ihn”)
gelb	yellow
keinerlei	none at all / absolutely none (“Er hat keinerlei Freunde”)
der Freund / die Freundin	the friend (die Freunde / die Freundinnen)
desto	“so much the better” (“Je mehr, desto besser” —&gt; “the more, the better”)
das Dorf	the village (die Dörfer)
der Spargel	the asparagus (die Spargel)
der Humor	the humor (die Humore)
zeigen	1) to exhibit/to feature/to display/to reveal/to offer<div><br /></div><div>pret: zeigt</div><div>part: gezeigt</div>
aussehen	to look (as in “you look good”) (“Dieser Stadt sieht unheimlich aus”)
schauen	to look (at something)/to see
ändern	"to alter/to change/to modify/to commute (""Er ändern das Buch"")"
erlauben	1) to allow/to permit/to admit/to concede<div><br /></div><div>pret: erlaubte</div><div>part: erlaubt</div>
aussteigen	1) to alight/to disembark/to exit
schwimmen	1) to swim/to float (Er ist geschwommen.)<div><br /></div><div>pret: schwamm</div><div>perf: geschwommen</div>
gefallen	1) to please/to oblige (“Die Röcke gefällen mir.”) (Es hat mir sehr gut gefallen.)<div><br /></div><div>pret: gefiel</div><div>part: gefallen</div>
abonnieren	1) to subscribe<div><br /></div><div>abonniert</div>
sammeln	"1) to gather/to collect/to compile (""Sie sammeln Berstein."")<div><br /></div><div>pret: sammelte</div><div>part: gesammelt</div>"
der Mann	the man/the husband (die Männer)
die Blume	the flower (die Blumen)
das Fenster	"the window (die Fenster) (""Schließen Sie alle Türen und Fenster!"")"
stehen	"1) to stand/to suit (""Viele Bäume stehen im Garten."") (Der Leher hat viele Fragen gestellt.)<div><br /></div><div>pret: stand</div><div>part: gestanden</div><div>kon1: stehe</div><div>kon2: stünde/stände</div>"
müssen	"1) (subject) must (verb, irregular — “Ich musse am Tisch essen”) (""Ich müss das Fenster öffnen."")<div><br /></div><div>muss</div><div>musste/mußte</div><div>gemusst/gemußt</div>"
können	1) to be able to (irregular)<div><br /></div><div>kann/kannst/kann/können/könnt/können</div><div>konnte</div><div>gekonnt</div>
gehen	1) to go/to walk<div><br /></div><div>pret: ging</div><div>part: gegangen</div>
wohin	1) whereto/where (Wohin sollen wir gehen?)
sollen	"1) shall/are supposed to/should (like deber — “Sie sollen in dem Bett schlafen”) (""Sollen wir ihm Glück wünschen?"")<div><br /></div><div>pret: sollte</div><div>part: gesollt</div>"
der Tisch	1) the table (“Die Tische”) (Eine Katze ist auf dem Tisch gewesen.)
wollen	"1) to want (irregular — “Willst du weniger?”; ""Meine Eltern wollen spazieren."")<div><br /></div><div>pres: ich will / du willst / etw. will / wir wollen / ihr wollt / sie wollen</div><div>pret: wollte</div><div>part: gewolt</div>"
sollten	(subject) should (it’s a verb, like deber)
das Mittagessen	1) the lunch (die Mittagessen)
machen	1) to make/to do/to render/to perform (Wir haben es gemacht.)<div>2) to render</div><div>3) to perform<br /><div><br /></div><div>pret: machte</div><div>part: gemacht</div></div>
mich	accusative personal pronoun
finden	1) to find (Hast du das Buch gefunden?)<div>2) to detect</div><div><br /></div><div>pret: fand / fund</div><div>part: gefunden</div>
lernen	to learn/to study (“Ohne dieses Buch könnte ich nicht lernen”)
dürfte	might (as in perhaps — “Dürfte ich essen?” / “Might I eat?” / “Would I be allowed to eat?” or “Er dürfte wieder gesund sein” / “He might be healthy again”)
wieder	again (“Der Senior kann wieder hören!”)
das Essen	"1) the food (die Essen) (""Er nimmt mein Essen."")"
gesund	healthy/sound/well/fit/wholesome
tatsächlich	1) actually/actual/indeed
Ihnen	formal you dative
bestätigen	to confirm/to approve/to endorse/to acknowledge/to affirm/to assert/to validate/to ratify
mieten	to rent/to hire/to lease
die Wohnung	the apartment (die Wohnungen)
die Toilette	the restroom/the toilet/the closet (die Toiletten)
wecken	to arouse/to wake/to awake/to call
aufwecken	to rouse/to arouse/to awaken [sb]
holen	1) to fetch/to get/to call<div><br /></div><div>pret: holte</div><div>part: geholt</div>
wiederholen	1) to repeat/to reiterate/to recur/to recapitulate/to revise/to review
entscheiden	1) to decide/to determine/to rule (Ich muss zwichen beiden Farben entscheiden.)<div><br /></div><div>entschied</div><div>entscieden</div>
scheiden	1) to divorce/to divide/to depart
dürfen	"1) to dare/to be authorized to (may) (“Dürfen wir mitmachen?”) (""Darf ich dir für deinem Name fragen?"")<div><br /></div><div>p: darf/darfst/darf/dürfen/dürft/dürfen</div><div>pr: durfte</div><div>perf: gedurft</div>"
mitmachen	1) to participate/to experience/to accede (less formal, like a pickup soccer game, than teilnehmen)<div><br /></div><div>machte mit / mitmachte</div><div>mitgemacht</div>
Man	one (agnostic singular pronoun)
teilnehmen	"1) to participate/to partake (more formal, like an embassy or competition, than mitmachen) (""Wer kann teilnehmen?"")"
tun	"1) to do -- sometimes interchangable with machen, sometimes not&nbsp;(""Ich kann es nicht tun."")<div>2) to put</div>"
aussagen	1) to state / to claim&nbsp;<div>2) to testify&nbsp;(“Ich sage für dich aus”)</div><div>3) to reveal</div><div><div><br /></div><div>pret: sagte aus</div><div>part: ausgesagt</div></div>
registrieren	to register/to log/to record
stellen	"1) to put/to place/to lay/to set/to stand (""Ich stelle eine Frage"")"
vorstellen	"to introduce/to suggest/to represent/to present/to imagine (reflexive) (“Ich stelle es dir vor” — i introduce [maybe?]) (""Ich will dich einmen Freund vorstellen."")"
spazieren	"1) to stroll (""Er spaziert mit seinem Vater"")"
wünschen	to desire/to wish/to require/to request/to want
betrachten	"1) to consider/to regard/to contemplate/to eye/to observe/to view/to behold/to sight (""Ich möchte das Schloss betrachten."")<div><br /></div><div>pret: betractete</div><div>part: betractet</div>"
passieren	to happen/to pass/to negotiate/to transpire/to occur/to strain (like pasta)
“Auf wen wartest du?”	“Whom are you waiting for?”
nehmen	1) to negotiate/to overcome<div>2) to accept [something]</div><div>3) to pick</div><div>4) to take/to use</div>
annehmen	1) to assume/to suppose/to presume (nehmen [something] an)<div>2)&nbsp;to adopt/to accept</div><div>3)&nbsp;to expect/to anticipate&nbsp;</div><div><br /></div><div>pret: nahm an / annahm</div><div>part: angenommen</div>
meinen	1) to mean<div>2) to deem/to reckon/to guess/to think</div><div>3) to intend</div>
schließen	1) to close/to shut<div>2) to conclude</div><div>3) to infer</div>
außen	outside
durch	through/across/done/by/via
prüfen	1) to examine/to check/to consider/to audit/to prove/to inspect/to survey/to verify<div><br /></div><div>pret: prüfte</div><div>part: geprüft</div>
stehlen	1) to steal/to poach (Sie haben meine Rollstuhl gestohlen.)<div>2)&nbsp;to borrow</div><div>3) to whip<br /><div><br /></div><div>pres: stehle/stiehlst/stiehlt/stehlen/stehlt/stehlen</div><div>pret: stahl</div><div>imper: stiehl / stehlt<br />kon1: stehle</div><div>kon2: stähle/stöhle</div></div>
wann	1) when (question) (Wann hast du Zeit?)
akzeptieren	to accept/to approve/to buy the truth of/to honour
besitzen	1) to possess/to own/to have/to hold<div>2) to occupy<div><br /></div><div>pret: besaß</div><div>part: besessen</div></div>
gehören	1) to rank among/to appertain to/to belong to<div><br /></div><div>pret: gehörte</div><div>part: gehört</div>
immer	"1) always/ever/throughout/invariably/forever (""Ein Stadtplan hilft immer."")"
der Student	<div>(die Studenten)</div>1) the (older/university) student
die Kneipe	<div>(die Kneipen)</div>1) the bar/the pub/the tavern (Diese Stadt hat viele Kneipen.)
viel	1) much/lots&nbsp;<div><br /></div><div>Tends to decline like a normal adj, but some exceptions:</div><div>1) in singular, often unchanged when no article or determiner (“Er hat viel Geld”)</div><div>2) in plural, usually declined even without article or determiner (“viele Kinder”) except certain combinations (“wie viel”, “so viel”))</div>
der Ort	the place/the location/the site (die Orte/die Örter)
die Fläche	the area/the surface/the expanse (die Flächen)
wie	how/like/as
das Ferienhaus	the cottage/the holiday home (die Ferienhäuser)
hinter	1) behind/rear/after (accusative or dative, based on showing movement or location)
welch	which/who/whichever (see declension tables)
wichtig	"1) important/vital/necessary/vitally/relevant (""Tourismus ist wichtig."")"
voll	full/crowded/entire/fraught/replete/ripe
der Nutzer	the user/the occupier (die Nutzer)
der Einwohner	the inhabitant/the resident/the citizen (die Einwohner)
der Verhältnis	the ratio/the relationship/the proportion/the affair (love) (die Verhältnisse)
die Bedienung	1) the service<div>2) the waitress/the waiter</div><div>3) the operation</div><div>(die Bedienungen)</div>
die Bindung	<div>(die Bindungen)</div>1) the bond/the commitment/the obligation/the tie&nbsp;<div>2) the liaison</div>
der Zusammenhang	the coherence/the context/the cohesion/the connection/the correlation/the relation (die Zusammenhänge)
der Verein	the society/the club/the association (die Vereine)
alt	old/ancient/stale/aged (älter; am ältesten)
besuchen	1) to visit/to attend/to see (Ich habe meine Mutter besucht.)<div><br /></div><div>pret: besuchte</div><div>part: bescuht</div>
die Verbindung	the tie/the compound/the connection (die Verbindungen)
lesen	1) to read<div>2) to pick (grapes)</div><div><br /></div><div>pres: ich lese / du liest / etw. liest / wir lesen / ihr lest / sie lesen</div><div>pret: las</div><div>part: gelesen</div><div>imper: lies / lest (pl)</div><div>kon1: lese</div><div>kon2: läse</div>
die Bevölkerung	the population/the populace (die Bevölkerungen)
die Öffentlichkeit	the public/the public sphere (die Öffentlichkeiten)
die Mitgliedschaft	the membership/the fellowship/the affiliation (die Mitgliedschaften)
der Bürger	the citizen/the commoner (die Bürger)
haben	1) to have/to possess ()<div>2) to be ill with</div><div><br /></div><div>pres: ich habe / du hast / etw. hat / wir haben / ihr habt / sie haben</div><div>pret: hatte</div><div>part: gehabt</div><div>imper: hab / habe / habt (pl) / habet (pl)</div><div>kon1: habe</div><div>kon2: hätte</div>
die Beziehung	the relationship/the respect/the relation/the regard/the tie/the affiliation (die Beziehungen)
die Schuld	<div>(die Schulden)</div>1) the debt/the blame/the fault/the guilt/the due
das Verständnis	the comprehension/the appreciation/the understanding/the insight (die Verständnisse)
rennen	to run/to race/ to careen/to dash
das Rennen	the run/the race (die Rennen)
der Hund	"the canine/the dog (die Hunde) (""Wir nehmen den Hund"")"
wieso	1) why (Wieso träumen wir?)
echt	1) genuine/real/authentic/proper ()
“Ich bin außer mir vor Freude”	“I am overjoyed” / “I am beside myself with joy”
vor	before/ago/ahead/pre-/previous/of
der Eindruck	1) the impression/the impact/the appeal (attraction)/the sensation (die Eindrücke)
“Wir träumen von einer Ente”	“We are dreaming about a duck”
lösen	to solve/to resolve/to tackle/to dissolve/to loosen/to crack
erklären	1) to explain/to declare/to state/to define/to elucidate
die Hochzeit	<div>(die Hochzeiten)&nbsp;</div>1) the wedding/the marriage/the heyday (“Die Hochzeit ist am Mittag”)
die Tasse	the cup/the mug (die Tassen)
“Ich werde zu diesem Zeitpunkt nicht da sein”	“I will not be there at this time.”
der März	March (die Märze)
das Jahr	"<div>(die Jahre)</div>1) the year (""Juni ist ein Monat des Jahres."")"
fest	firm/solid/firmly/concrete/tight/tightly/fixed/sturdy
“Der Termin steht fest”	“The appointment stands firm” / “The appointment is set”
zu	(always dative) to/towards/at/unto/for/in/too (excessively)
perfekt	perfect/consummate/perfectly
der Berg	the mountain/the heap/the pile (die Berge)
hilfreich	1) helpful/auxiliary/assistant (“Manchmal ist er hilfreich”)
die Praxis	"1) the surgery (doctor’s office)/the practice (""Sie ist selten in der Praxis."") (""Sie sind überhaupt schlecht. Mit Glück, sie sind jedoch selten."") (Wie sieht ihre Praxis aus?)<div>2) the experience&nbsp;</div><div><br /></div><div>(die Praxen)</div>"
wenn	1) when/if/once (only used for real conditions, not indirect questions like “I do not know, if she is waiting” — use ob (whether) instead”) (Wenn nicht, was dann?)
das Medikament	<div>(die Medikamente)</div>1) the medcation/the drug
der Mensch	the human/the person (die Menschen)
die Natur	nature (natural world)/character (die Naturen)
normal	ordinary/normal/standard/normally
der Weg	"1) the path/the way/the route (die Wege) (""Kannst du mir den Weg zeigen?"")"
das Restaurant	the restaurant/the eatery (die Restaurants)
vielleicht	maybe/perhaps/possibly
das Meer	the sea/the ocean (die Meere)
der Zug	<div>(die Züge)</div>1) the train<div>2) the tug/the drag/the draw</div><div>3) the platoon</div>
die Fahrt	the journey/the trip/the drive/the ladder/the trap (die Fahrten)
der Februar	February (die Februare)
der Monat	the month (die Monate)
heiß	1) hot<div>2) ardently</div><div>3) torrid</div>
sehr	very/greatly/much
jeder	each/everyone/anyone/everybody/anybody/any/all
vorbei	1) past / over (Deine Zeit ist vorbei.)
kalt	cold/chilly
wirklich	really/actually/truly/real/indeed
der Sommer	summer (die Sommer)
allein	1) alone/solitary<div>2)&nbsp;solely</div><div>3) however</div>
darüber	"1) overhead/across<div>2) therefore</div><div>3) about it or that (""Wir sprechen darüber."")</div>"
damit	"1) thereby/therewith/so/hence (""Er kocht damit wir essen können."")<div>2)&nbsp;with that (""Sind Sie damit fertig?"")</div><div><br /></div><div><br /></div><!--anki-->"
selbst	"1) even (""Selbst ich trinke Milch."")<div>2) themselves/itself/yourself/[]self</div>"
weder	"1) neither/not either (used with ""noch = nor"")"
weder … noch	either … or / neither … nor
bereits	1) already (“Sie sind bereits im Haus”)
“sowohl [something] als auch [something else]”	sowohl means “and”, but like this — “both [something] and [something else]”; “Ich trinke sowohl Tee als auch Wein”
zuerst	first/initially/primarily
nun	"1) now/“well?”/at the moment (""Nun ist er wirklich hier!"")"
zuletzt	"1) (adj) last (""Der Spaß kommt zuletzt."")<div>2) (adv) finally/lastly<div>3) (adv) recently/lately</div></div>"
genauso	1) equally/as/similarly/ditto
selber	myself/itself/yourself/himself/herself/ourselves/yourselves/self
der Kopf	die Köpfe
dabei	"1)&nbsp;pronominal adverb of bei (replaces bei + demonstrative or personal pronoun, unless referring to people) (""Was ist schon dabei?"" == ""What is the matter with it?"")<div>2) (adv) with one/on one (""Has du Geld dabei?"")</div><div>3) (adv) indeed/actually (express contradiction) (""Er will einkaufen gehen. &nbsp;Dabei ist heute Sonntag."")</div><div>4) (adv) in the process of (""Ich bin dabei, meine Wohnung zu streichen."")</div>"
dazu	"1) (adv) for that purpose (""Das Pferd ist dazu perfekt."")<div>2) (adv) in addition to it/besides</div><div>3) (adv) to it/to that</div>"
“Das Pferd ist dazu perfekt”	“The horse is perfect for it”
das Getränk	the drink/the beverage (“die Getränke”)
sonst	"1) else/otherwise/besides/further (""Sonst noch etwas?"")<div>2) usually</div>"
“Sonst noch etwas?”	“Something else?” (literally perhaps “Still something else?”)
völlig	entirely/utter/completely (“Das ist völlig falsch”)
falsch	false/wrong/fakse
jedenfalls	1) in any case (“Wir sind jedenfalls eine Familie”)<div>2) anyway</div>
durchaus	quite/thoroughly/definitely (“Das ist durchaus so”)
so	so/thus (in this way/like this)/as
einmal	"1) once (""Sie isst einmal im Monat Mittagessen mit ihrem Vater."") (""Nein, nicht alles auf einmal."")<div>2) disposable</div><div>3) someday</div>"
“Sie geht einmal im Monat”	“She goes once a month”
daher	therefore/hence/thus/so (“Daher ich habe einen Hund”)
der Name	the name/the moniker (die Namen)
das Tor	"<div>(die Tore)</div>1) the gate&nbsp;<div>2) the goal (""Ich habe mindestens zehn Tore."")</div><div>3) the fool</div>"
mindestens	at least (“Ich habe mindestens zehn Tore”)
besonders	"1) particularly/especially/peculiar/extra (“Mein Haus ist besonders groß”) (""Der Apfel is besonders grün."")<div>2) special (Das ist besonders.)</div>"
kaum	1) hardly/barely/scarcely (“Er kann kaum gehen”)
außerdem	"1) besides/moreover/furthermore/additionally/also (“Es ist außerdem gesund.”; ""Er arbeitet außerdem als Autor."")"
jedoch	"1) however/yet/nevertheless (""Sie sind langsam, aber sie sind jedoch nicht fit”)"
erneut	1) again/anew/renewed (“Ich sehe dich erneut”)
meistens	"1) mostly/usually (“Ich bezahle meistens”) (""Meistens kommen die Großeltern alle zwei Tage."")"
überhaupt	"1) absolutely (“Das ist überhaupt nicht gut”) (""Er sieht überhaupt nicht wie ein Artz aus."")<div>2)&nbsp;anyway ()</div><div>3) generally ()</div>"
der Alkohol	<div>(die Alkohole)</div>1) the alcohol/the booze/the spirit
notwendig	1) necessary/essential/indispensable (Eine Therapie ist nicht notwendig.)
der Rollstuhl	the wheelchair (die Rollstühle)
verkaufen	1) to sell/to vend/to market/to realize (econ) (Ich habe mein Auto verkauft.)<div><br /></div><div>pret: verkaufte</div><div>part: verkauft</div>
das Pflaster	the plaster/the patch/the pavement/the cobbles/the adhesive bandage (die Pflaster)
kostenlos	1) complimentary/free/costless (Wir essen, weil das Essen kostenlos ist.)
weil	because (since/as/for)
euch	you (accusative/dative form of ihr — familiar 2nd person plural (du for plural))
das Englisch	English language
die Farbe	1) the color/the paint (die Farben)
zwischen	1) among/between/amongst/inside (Ich muss zwichen drei Zeitpunkte entscheiden.)
beide	both/(the) two (much more common than in English — if there are two of something, use it (“meine beiden besten Freunde”); declines like adjectives, but has two forms — beide and beides, for singular or plural.  beides for situations/choices, beide for people, and either for things)
der Mond	<div>die Monde</div>1) the moon
“Sie müssen mich morgen um neun Uhr wecken”	“You have to wake me up at nine o’clock tomorrow”
anreden	to address [sb]/to style [sb]
parken	1) to park (as in a car)<div><br /></div><div>pret: parkte</div><div>part: geparkt</div>
das Wasser	1) water (die Wässer)
“Das ist der Hund des Mannes”	“That is the dog of the man” (genetive possessive) — von construction — (“Das ist der Hund von dem Mann”)
klein	"1) small/little/short/minor (""Er ist weder groß noch klein."")"
trotz	1) despite/notwithstanding ()
die Größe	<div>(die Grösen)</div>1) the size/the magnitude<div>2) the extent</div>
schnell	quickly/fast/swift
während	"1) during/while/whereas/whilst<div>- use genetiv if possible</div><div>- use dative is genetive case would be indistinguishable from nominative form</div><div>- use dative with pronouns that have no genetiv case, and if a possessive genetiv is preceding the referent of the preposition (""Ich wurde während etwas Wichtigem angerufen.""; ""Ich wurde während Peters langem Vortrag angerufen."")</div>"
der See	<div>(die Seen)</div>1) the lake
die Lampe	<div>(die Lampen)</div>1) the lamp/the light
das Kind	the child (die Kinder)
die Zeitung	the newspaper (die Zeitungen)
frei	1) free/spare/available/vacant/blank/loose (Hast du am Dienstag frei?)
der Tag	the day (die Tage)
müde	"1) tired/sleepy/weary/dull (""Ich bin müde; Ich brauche schlafen."")"
die Ente	the duck (die Enten)
der Kunde / die Kundin	the customer/ the client (die Kunden / die Kundinnen)
kommen	"1) to come/to arrive/to cum/to go (“Die Kundin kommt zu spät” / “Ich komme!”) (""Ich habe aus Chicago gekommen."")<div><br /></div><div>pret: kam</div><div>perf: gekommen</div>"
der Mittag	noon/midday/lunchtime (die Mittage)
“He goes to bed at 8”	“Er geht um acht ins Bett”)
das Bett	<div>(die Betten)</div>1) the bed<div>2) the sack</div><div>3) the bedding</div>
genau	exactly/accurate/precisely/true
erkennen	"1) to realize<div>2) to recognize (""Wir erkennen nichts"")</div><div>3) to discern/to distinguish</div><div>4) to perceive/to spot/to detect</div>"
die Tür	"1) the door (Türen) (""Bitte schließen Sie die Tür"")"
liegen	"1) to lie/to rest/to sit (be in a horizontal position) (""Er liegt auf dem Sofa"")<div>2) to reside (e.g., in data memory)<br /><div>3) to suit [subject]</div></div>"
unter	"1) among/amongst<div>2) below/under/beneath/underneath (""Der Apfel liegt unter dem Stuhl"")</div>"
alles	"1) (pron) everything (""Das ändert alles"")<div>2) (adj/pron) all</div><div>3) anything</div><div><br /></div><div>nominative/accusative femine and plural: 'alle'</div>"
fünfte	"1) the fifth (""Das fünfte Mal"")"
anderer	"1) (adj/pron) another (""Ein anderes Mal."")<div><br /></div><div>NOTES:</div><div>- declines like an adjective, and is used both adjectivally and as a noun. m: anderer; f: anfere; pl: anderes</div>"
das Reis	"1) the rice (die Reiser) (""Er hat weniger Reis."")<div>2) the slip (for grafting) ()</div><div>3) the sprig ()</div>"
die Gruppe	"1) the group/the squad/the band (""Es gibt zahlreiche Gruppen."")<div>2) the cluster/the clump</div><div>3) the bank</div>"
schon	"<div>very hard to translate, means multiple things in different contexts</div><div><br /></div>1) already/beyond (BUT negation of already -- i.e. ""not yet"" or ""not already"" is NEVER schon, it is ""noch nicht"") (""Er ist schon da."")<div>2) to indicate something is kind of earlier/less than expected (like ""already"", but without the notion of ""accomplishment"", like ""wow, that happens kinda quite earlier than expected"" -- can be seen as opposite of ""erst"", which means ""wow, that's not so much (yet)"") (""Ich habe vergessen, meinem Ches zu sagen, dass das Meeting morgen schon um fünf anfängt."" -- ""I have forgotten to tell my boss thatv the meeting tomorrow starts at five, which is earlier than expected.""; ""Ich gehe morgen schon um zwolf nach Hause."" -- ""I am going home tomorrow at 12, which is ealier than expected or usual or recommended"")<div>2) fixed expression: ""schon wieder"" -- ""already again?"" -- ""wieder"" is technically just epxressing that something is reoccuring, and ""schon"" provides what is implied in English, which is the idea of ""wow, that's kinda early for again"" (""Papa, Ich muss mal."" ""Schon wieder???"")</div></div><div>3) fixed expression: ""schon mal"" - ""before/aready"" in a less definite ""thing has been completed"" way than just ""schon"". &nbsp;(""Das habe ich schon mal gehört"" ""I've heard that before [open ended]"" vs if just schon it's like ""I've heard that already [so no need to hear it again]"") &nbsp;In a question, ""schon mal"" is like ""ever?"" &nbsp;Perhaps ""Warst du schon in Paris?"" for real life, but ""Warst du schon in Paris?"" for ""checking capital cities off the go-to bucket list"". &nbsp;Another ex: ""Has du schon mal eine Diät gemacht?"" ""Ne, noch nie.""</div><div>4) express impatience in command: ""Sag schon!"", ""Gib schon!"", ""Ach, komm schon!"" (this last one doesn't work if you want to doubt a statement, so use ""Ach hör auf"" instead</div><div>5) coloring: 'dispersing doubt' or 'encouraging someone'. &nbsp;Maybe translated as ""don't worry/let it go/chill out"". (""Oh Gott, morgen ist Klausur. &nbsp;Ich bin soooo nervös."" ""DU schaffst das schon."") (""Wo ist denn Marie? &nbsp;Die wollte doch eigentlich um sieben da sein."" ""Ach die kommt schon noch."") (""Das sieht komisch aus... schreibt man das so?"" ""Ja ja, das ist schon richtig so."")<br /></div><div>6) ""geht schon"": ""things are going OK enough, don't worry."" (""Hey alles ok, bist du verletzt?"" ""Nee [nah], geht schon."") (""Und wie ist die Suppe?"" ""Naja [meh], geht schon, ist schon ganz lecker."")</div><div>7) 'dispersig doubt' by making a question rhetorical in the negative: ""Thomas? Was wil der schon machen?"" -- ""Thomas? &nbsp;What is HE gonna do?"" (as in he can't do anything). ""Ich könnte sie ja anrufen, aber was bringt das schon?"" (as in what would THAT accomplish to call her? nothing.) &nbsp;""Wen interessiert das schon?"" ""Wer hat schon so viel Zeit?"" &nbsp;So, implies the answer to the question is something like ""nothing"" or ""no one"".</div><div>8) 'dispersing doubt' by making a question rhetorical in the positive: ""Du kommst schon morgen, oder?"" (""you WILL come tomorrow, right?"") Much stronger doubt dispersion than ""noch"", which has idea of affirmation. &nbsp;""Du hast doch einen Fürhrerschein, oder?"" vs ""Du has schon einen Fürhrerschein, oder?"" -- second example sounds WAY more convinced, where 'doch' is yearning for affirmation because it is just not sure.</div><div>9) 'disperse doubt by' accepting or conceding there is no way around one condition to set up a corresponding condition: ""Wenn du schon zu spät kommst, dann ruf wenigstens an."" (""If you are late, then at the very least call me."") ""Wenn ich schon eine Liebeskomöde sehen muss, dann bitte eine richtig schmalzige."" (If, by all means, I really have to watch a romantic comedy, then make it a really schmaltzy one.) ""Wenn ich das schon machen muss, dann will ich aber auf jeden Fall das und das."" (If i really have to do it, and there seems no way around it, then I definitely want this and that.)</div>"
der Koch / die Köche	"1) the cook/the chef (""Köche kochen damit es Essen für die Familien gibt."")"
der Autor	"1) the author/the writer/the novelist (""Er arbeitet außerdem als Autor."")<div>(die Autoren)</div>"
nie	"1) never (""Diese Frau kann meine Großmutter nie ersetzen."")"
das Ende	"(die Enden)<div>1) the end/the ending/the finish/the tail (""Alles hat einmal ein Ende."")</div>"
der Strand	"<div>(die Strände)</div>1) the beach/the shore (""Der Strand is weiß."")"
der Bernstein	<div>die Bernsteine</div>1) the amber
die Umwelt	"<div>die Umwelten</div>1) the environment (""Das ist gut für die Umwelt."")<div>2) the surroundings</div>"
die Wiese	"(die Wiesen)<div>1) the meadow/the pasture/the grassland (""Auf der grünen Wiese."")</div>"
das Gras	(die Gräser)<div>1) the grass ()</div><div>2) the weed/the pot/the bud etc</div><div>3) the herbage</div>
die Welle	(die Wellen)<div>1) the wave</div><div>2) the surge</div><div>3) the shaft</div><div>4) the billow</div>
die Tierwelt	(die Tierwelten)<div>1) the animal kingdom</div><div>2) the fauna</div>
die Welt	"(die Welten)<div>1) the world/the Earth (""Die Welt ist klein."")</div>"
das All	(no plural listed)<div>1) the universe</div><div>2) outer space</div>
der Wald	<div>(die Wälder)</div>1) the forest/the woodland&nbsp;
der Rhein	"1) Rhine (""Der Rhein ist ein Fluss."")"
der Fluss	(die Fluß)<div>1) the current</div><div>2) the river</div><div>3) the flux (physics, electricity)</div><div>4) the flow</div>
der Bach	"(die Bäche)<div>1) the stream/the creek/the brook (""Der Bach ist klein."")</div><div>2) the ditch</div>"
die Landwirtschaft	(die Landwirtschaften)<div>1) the agriculture</div><div>2) the farming</div><div>3) the husbandry</div>
der Strom	<div>(die Ströme)</div>1) the river (big, maybe emptying into sea and having tributaries)<div>2) the current/the electricity/the power</div><div>3) the tide/the flow/the fush/the gush</div>
das Klima	"(die Klimata)<div>1) the climate (""Ich mag das Klima."")</div>"
die Wüste	"(die Wüsten)<div>1) the desert (""Die wüste liebt."")</div><div>2) the barren wasteland</div><div>3) the wilderness</div>"
leben	1) to live/to exist<div>2) to home</div>
die Pflanze	"(die Pflanzen)<div>1) the plant (""Er findet keine Pflanzen."")</div><div>2) the vegetable</div>"
der Umzug	"(die Umzüge)<div>1) the move (change of house)/the relocation (""Ein Umzug macht Spaß!"")</div><div>2) the procession</div><div>3) the removal</div><div>4) the migration</div><div>5) the parade</div>"
verheiratet	"1) married (""Bist du verheiratet?"")"
der Zwilling	"(die Zwillinge)<div>1) the twin (""Wir sind Zwillinge."")</div><div>2) the Gemini (""Ich bin einen Zwilling."")</div>"
schwanger	"1) expecting<div>2) pregnant (maybe same as 1)?) (""Nein, ich bin nicht schwanger."")</div>"
die Tante	"(die Tanten)<div>1) aunt (""Meine Tante trinkt saft."")</div>"
die Nichte	"(die Nichten)<div>1) the niece (""Meine Nichte schläft."")</div>"
der Enkel / die Enkelin	"(die Enkel / die Enkelinnen)<div>1) grandchild / grandson / granddaughter (""Er hat sechs Enkel und siebenzehn Urenkel."")</div>"
der Urenkel / die Urenkelin	(die Urenkel / die Urenkelinnen)<div>1) the great-grandchild / the gread-grandson</div>
der Verwandte / die Verwandte	"(die Verwandten)<div>1) the relatives (""Ich mag meine Verwandten."")</div>"
der Neffe	"(die Neffen)<div>1) the nephew (""Er ist mein Neffe."")</div>"
die Urgroßmutter	"(die Urgroßmütter)<div>1) the great grandmother (""Wo ist meine Urgroßmutter?"")</div>"
der Rock	"(die Röcke)<div>1) the skirt (""Der Rock ist für meine Tante."")</div>"
ziemlich	1) quite/rather<div>2) fairly/pretty/reasonably<br /><div>3) considerable/reasonable</div></div>
nach	"1) towards<div>2) after (later in time or order or importance)</div><div>3) to (""Ich gehe nach&nbsp;Österreich."")</div><div>4) past</div><div>5) on</div><div>6) post-</div><div><br /></div>"
das Rot	"1) the color red (Ich mag Rot.)<div><br /></div><div>(adj) red (""Es ist fast rot."")<div><div>röter/roter; am rötesten/rotesten; roter rote rotes; rötester/rotester; röteste/roteste; rötestes/rotestes</div></div></div>"
die Tasche	"(die Taschen)<div>1) bag (""Das ist die Tasche meiner Mutter."")</div><div>2) pocket</div>"
dessen/deren/dessen/deren	"relative pronouns in genetiv case<div>(plural also gets ""denen"" in dative when relative, rest are same)</div>"
general rules for genetiv noun declension	"1) ""-es"" ending:<div><div>Nevertheless, in the genitive, the ending -es is used …</div><div>- necessarily if the word ends with a sibilant (des Hauses, des Stoßes, des Schusses)</div><div>- usually by monosyllabic words (des Gottes, des Mannes)</div><div>- commonly if it ends on the letter d</div></div><div><br /></div><div>2) only words of more syllables usually add a simple -s</div>"
general rules for dative noun declension	"<div>1) most nouns do not take declensions in dative.</div><div>2) a small class of mostly masculine nouns called ""weak nouns"" takes -n or -en in all cases except nominative. &nbsp;However, in colloquial usage, sometimes the inflection is omitted.</div><div>3) dative forms ending in -e (""Dative-e"") are mostly restricted to formal/archaic usage. &nbsp;But, some common words persist: (dem) Hause, Wege, or Tode)</div>4) the dative plural of all nouns ends in -n if such an ending does not already exist, except that of nouns that form the plural with -s, which are usually loan words"
general rule for feminine noun declension	1) all singular forms are identical
which cases needed to determine entirety of a noun's declension	1) nominative singular, 2) genetiv singular, 3) nominative plural
der Hut	"(die Hüte)<div>1) the hat (particularly still/formal hats and/or hats with brims) (""Er trägt den hut seiner Freundin."")</div>"
der Bruder	"(die Brüder)<div>1) the brother (""Das ist die Frau, deren Bruder krank ist."")</div>"
das Herz	"(die Herzen)<div>1) the heart (""Das ist der Weg des Herzens."")</div><div><div>Herz has irregular singular declension and is the only noun of its kind.</div><div>- The genitive singular generally takes the ending -ens: des Herzens.</div><div>- The dative singular traditionally takes -en: dem Herzen. Accepted standard form in many expressions, such as im Herzen, von Herzen, zu Herzen, Operation am offenen Herzen, mit halbem Herzen, and others.</div><div>- Otherwise, the forms dem Herzen and dem Herz are both acceptable. The latter is predominant in speech, while the former remains the more established form in writing.&nbsp;</div><div>- But only the bare form is common for Herz as a card suit or a term of endearment, as well as in the phrase mit Herz ‎(“good-hearted”).</div></div>"
die Woche	"<div>(die Wochen)</div>1) the week (""Freitag ist der fünfte Tag der Woche."")"
Schweizer	1) Swiss
der Stadtplan	(die Stadtpläne)<div>1) the city map ()</div>
Wien	Vienna<div>(Wein braucht ein bischen Tourismus)</div>
die Fähre	"(die Fähren)<div>1) the ferry (""Die Fähren sind langsam."")</div>"
Österreich	Austria
die Kuh	"(die Kühe)<div>1) the cow (""Der Schweizer hat eine Kuh."")</div>"
Bayern	"Bavaria<div>(""Sie kommt aus Bayern."")</div>"
der Chef / die Chefin	"<div>(die Chefs)</div>1) the boss (""Wo ist der Chef?"")"
helfen	1) to help/to support/to assist/to bolser ()<div><br /></div><div>p: helfe/hilfst/hilft/helfen/helf/helfen</div><div>pr: half</div><div>perf: geholfen</div><div>imper: hilf/helft</div><div>kon1: helfe</div><div>kon2: hülfe/hälfe (euch)</div>
das Land	"(die Länder)<div>1) the country (""Österreich ist ein Land."")</div>"
der Käse	"(die Käse)<div>1) the cheese (""Der Käse kommt aus Bayern."")</div>"
beraten	"1) to advise/to counsel (""Wir werden dich beraten."")<div><br /></div><div>pret: beriet</div><div>perf: beraten</div>"
handeln	"1) to deal/to act (""Wir werden handeln."")<div>2) to trade/to negotiate/to bargain</div>"
die Schule	"(die Schulen)<div>1) the school (""Er wirt zur Schule gehen."")</div>"
nichts	"1) nothing/not anything (""Sie werden nichts merken."")"
sich merken	"1) to keep [something] in mind (""Ich werde es mir merken."")<div>2) to learn/memorize [something]</div><div>3) to memorize</div>"
article rules for jobs/professions/students	usually drop the indefinite article, unless there is an adjective
der Enwickler (die Entwicklerin)	(die Entwickler / die Entwicklerinnen)<div>1) the developer (? software?)&nbsp;</div>
der Teilnehmer	"(die Teilnehmer)<div>1) the participant/the attendee/the competitor (""Er ist der Teilnehmer."")</div>"
das Personal	"1) the staff/the personell (""Das Personal ist gut."")"
der Betreiber	(die Betreiber)<div>1) the operator</div><div>2) the carrier</div>
der Empfänger	"<div>(die Empfänger)</div>1) the recipient/the addressee (""Kennst du den Empfänger?"")"
der Verfasser	"(die Verfasser)<div>1) the author/the writer (""Ich bin nicht der Verfasser."")</div>"
die Werkstatt	(die Werkstätten)<div>1) the workshop ()</div>
das Handwerk	(Die Handwerke)<div>1) the craft/the handicraft/the trade ()</div>
der Schneider	"(die Schneider)<div>1) the tailor (""Er ist die beste Schneider)</div>"
der Hersteller	(die Hersteller)<div>1) the manufacturer/the producer&nbsp;</div>
der Laden	"(die Läden)<div>1) the shop/the store/the premise (""Der Schneider ist im Laden."")</div>"
die Telefonnummer	"(die Telefonnummern)<div>1) the telephone number (""Der Hersteller hat keine telefonnumer."")</div>"
der Experte	(die Experten)<div>1) the expert ()</div>
der Richter	(die Richter)<div>1) the judge ()</div><div>2) the bench (judicial)</div>
der Rechtsandwalt	"(die Rechtsandwëlte)<div>1) the attorney (""Die Person hat keine Rechtsandëlte."")</div>"
die Spezialität	"(die Spezialitäten)<div>1) the speciality (""Was ist Ihre Spezialität?"")</div>"
Ihrer	formal you genetiv
ihrem	masculine and neuter dative possessive for female
die Zahnpasta	(die Zahnpasten)<div>1) the toothpaste (Die Zahnpasta ist hinter dem Spiegel.)</div>
die Zahnbürste	<div>(die Zahnbürsten)</div>1) the toothbrush
der Grund	<div>(die Grunde)</div>1) the reason/the cause ()<div>2) the ground/the bottom ()</div><div><br /></div>
der Bereich	<div>die Bereiche</div>1) the realm/the range/the area ()<div>2) the department ()</div>
der Bezirk	die Bezirke<div>1) the district/the borough (“Zu welchem Bezirk gehörst du?”)</div>
das Grundstück	die Grundstücke<div>1) the property/premises (Das ist mein Grundstücke.)</div>
alle	"1) colloq: ""gone""/finished (""Die Milch ist alle."")<br /><div><br /></div><div>nominative/accusative femine and plural of 'alles' ()</div>"
"""überhaupt nicht"""	"""not anything"""
"case for comparison with ""wie"""	"normally use the same case as the noun/pronoun they refer to. (""Er sieht wie ein Artz aus."")"
anspreche	"1) to respond to/to react ()<div>2) to address/to approach (""Ich spreche ihn erneut an."")</div><div>3) to operate ()</div>"
"verbs that are exceptions to ""use Perfekt instead of Präteritum when speaking"" rule"	sein, haben, wissen, and the modal auxiliaries (dürfen, können, müssen, sollen, wollen) -- they can be used in Präteritum in informal contexts as well
what is Perfekt NOT used to describe?	"things that started in the past and are still occurring. &nbsp;in english we say ""I have been living here three years"" -- perfekt -- but in german it is &nbsp;""Ich lebe seit drei Jahren hier."""
form present participle of a verb and state its uses	- add -d to the infinitive<div>- by far most common use is as an adjective. &nbsp;like any other adjective, declines with case when used attributively.</div>
general rules for forming past participle	"weak verb: ge + infinitive stem + (e)t<div>strong verb: ge + perfect stem + en</div><div>mixed verb: ge + perfect stem + (e)t</div><div><br /></div><div>exceptions:</div><div>- verbs with separable prefixes include the ge- between the prefi and the verb stem</div><div>(e.g., angefangen, aufgeregt, zurückgebracht)</div><div>- verbs with inseparable prefixes in their infinitive forms omit the ge- prefix entirely (e.g., verkommen, erzählt, bewusst)</div><div>- verbs with -ieren omit the ge- (these verbs are also all weak, so end in -t, e.g. studiert, repariert, manipuliert)</div><div>- used in all perfect tenses (present, past, future), and used in all 6 tenses of passive voice</div><div><br /></div><div>notes:</div><div>- perfect stem is ""special"" for this tense.</div><div>- there are relatively few mixed verbs.</div>"
what are weak verbs and some characteristics?	- follow basic, predictable pattern in every tense<div>- all tenses formed using present infinitive stem</div><div>- signifier for past tense is dental suffix: simple past takes -te on end, and participle takes -(e)t on end. &nbsp;the endings are preceded by an e- where the verb stem ends in&nbsp;-d or -t, or in -m or -n preceded by a consonant other than l or r).</div><div>- unique among germanic languages, including english.</div><div>- largest category of verbs</div><div>- still expanding. &nbsp;any new words as a result of technology or adoption of foreign words are weak (e.g., telefonieren, surfen, downloaden)</div><div><br /></div>
what are strong verbs and some characteristics?	- strong verbs have stem changs to help signify verb tense<div>- stem changes are not predictable and must be learned</div><div>- not all have stem changes in every tense (e.g., gefahren, gekommen)</div><div>- some have stem changes in simple present (e.g., fährt, spricht), but most do not (e.g., gehe--ging--gegangen, trinkt--trank--getrunken, kommt--kam-gekommen, schreibt--schreib--geschreiben)</div>
die Tüte	"(die Tüten)<div>1) the bag (""Ich habe eine Tüte."")</div>"
der Supermarkt	(die Supermärkte)<div>1) the supermarket</div>
der Kunde	(die Kunden)<div>1) the customer ()</div><div>2) the client ()</div><div>3) lore ()</div>
die Apotheke	(die Apotheke)<div>1) the pharmacy/the drugstore (Das ist die Apotheke.)</div>
der Gutschein	(die Gutscheine)<div>1) the voucher/the coupon (Das ist kein Gutscheine.)</div>
die Einkaufswagen	(die Einkaufswagen)<div>1) the shopping cart (Das ist mein Einkaufswagen.)</div>
das Sonderangebot	(die Sonderangebote)<div>1) the bargain offer/the promotion (Das ist ein gutes Sonderangebot.)</div>
niemand	1) nobody/no one (Niemand kann mir heflen.)
sagen	"1) to say/to tell/to speak (""Du kannst nicht ""nein"" sagen."") (Was hat er gesagt?)<div><br /></div><div>pret: sagte</div><div>part: gesagt</div>"
sein	1) to be<div><br /></div><div>p: ich bin / du bist / etw. ist / wir sind / ihr seid / sie sind</div><div>pret: war</div><div>part: gewesen</div><div>imper: sei / seid (pl)</div><div>kon1: sei</div><div>kon2: wäre</div>
das Krankenhaus	die Krankenhäuser<div>1) the hospital (Das Krankenhaus soll für meine Therapie bezahlen.)</div>
erfahren	1) to experience (something) (Ich habe alles erfahren)<div>2) to hear/to learn</div><div>3) to undergo/to suffer</div><div><br /></div><div>pre: erfuhr</div><div>perf: erfahren</div>
geben	1) to give/to bestow<div>2) to deal</div><div><br /></div><div>pres: gebe/gibst/gibt/geben/gebt/geben&nbsp;</div><div>pret: gab</div><div>perf: gegeben</div><div>imper: gib / gebt</div><div>kon1: gebe</div><div>kon2: gäbe</div>
behalten	1) to retain/to keep<div>2) to memorize</div><div>3) to remember (Hast du es behalten?)</div><div><br /></div><div>pret: behielt</div><div>part: behalten</div>
verbessern	1) to improve/to enhance (Ich habe es verbessert.)<div>2) to advance</div><div>3) to hone/to correct</div><div><br /></div><div>pret: verbesserte</div><div>imper: verbessert</div>
veröffentlichen	1) to publish (something) (Sie hat drei Bucher veröffentlicht)<div>2) to release/to announce</div><div>3) to advertise</div><div><br /></div><div>pret: veröffentlichte</div><div>pref: veröffentlicht</div>
schreiben	1) to write (Er hat aufs Soda geschreiben.)<div>2) to record</div><div><br /></div><div>pret: schrieb</div><div>perf: geschrieben</div>
fragen	1) to ask (Er hat mich gefragt.)<div>2) to request</div><div><br /></div><div>pret: fragte / frug (regional auch)</div><div>perf: gefragt</div>
laufen	1) to run (Ich habe jeden Tag deinem Haus gelaufen.)<div>2) to walk</div><div>3) to operate</div><div>4) to weep</div><div>5) to melt</div><div><br /></div><div>pres: laufe/läufst/läuft/laufen/lauft/laufen</div><div>pret: lief</div><div>perf: gelaufen</div><div>imper: lauf / laufe ; lauft (plural)</div><div>kon1: laufe</div><div>kon2: liefe</div>
erzählen	1) to tell/to narrate/to relate (Er hat mir alles erzählt.)<div><br /></div><div>pret: erzählte</div><div>perf: erzählt</div>
informieren	1) to inform/to brief (Wer hat dich informiert?)<div>2) to acquaint</div><div><br /></div><div>pret: informierte</div><div>perf: informiert</div>
alguien	1) someone/sombody (Alguien vio lo que pasaba?)
die Brust	(die Brüste)<div>1) the chest/the breast ()</div><div><br /></div><div><br /></div>
das Blut	die Blute<div>1) the blood ()</div>
der Rücken	die Rücken<div>1) the rear (portion) ()</div><div>2) the back (body part) ()</div>
der Arm	(die Arme)<div>1) the arm (body part) ()</div>
der Gesicht	(die Gesichter)<div>1) the face ()</div><div>2) the visage ()</div>
das Haar	(die Haare)<div>1) the hair (Magst du meine Haare?) (Gefallen dir meine Haare?)</div>
das Ohr	(die Ohren)<div>1) the ear (body part) (Wir haben zwei Ohren.)</div>
verpassen	1) to miss [something] (Die Frauen verpassen das Essen.)<div>2) to forfeit [something]</div><div><br /></div><div>pret: verpasste /&nbsp;verpaßte</div><div>part: verpasst / verpaßt</div>
scheinen	1) to seem/to appear (Sie scheint traurig.)<div>2) to shine/to glisten ()</div><div><br /></div><div>pret: schien</div><div>part: geschienen</div>
traurig	1) sad ()
das Bier	(die Biere)<div>1) the beer/the ale (Wir bestellen ein Bier.) (Wir trinken im Oktober Bier.)</div>
zutreffen	1) to apply/to pertain (Dies trifft nicht zu.)<div><br /></div><div>pret: traf zu / zutraf</div><div>part: zugetroffen</div>
ernst	1) serious / severe / grave<div>2) earnest<br /><div><br /></div><div>noun: der Ernst</div></div>
wo	1) where (Wo ist die Not?)
nützlich	1) useful/handy (Is das nützlich?)
unabhängig	1) independent (Die Großmutter ist unabhängig.)<div>2) sovereign</div>
abhängig	1) additcted<div>2) dependent</div><div>3) conditional</div><div>4) oblique</div>
klar	1) clear (Das ist klar.)<div>2) lucid</div><div>3) plain/obvious/evident</div><div>4) distinct</div>
aufregen	1) to upset<div>2) to excite (Wir sind nicht aufgeregt)</div><div>3) to agitate</div><div><br /></div><div>pret: regte auf / aufregte</div><div>part: aufgeregt</div>
wahrscheinlich	1) probably/probable (Was ist wahrscheinlich?)<div>2) presumably/presumable</div>
verpflichten	1) to be in [sb's] dept<div>2) to be committed / to be obligated (Ich bin nicht verpflichtet)</div><div><br /></div><div>pret: verpflichtete</div><div>part: verpflichtet</div>
zufrieden	1) pleased/satisfied/contnent/contentedly (Wir sehen, dass die Familie zufried ist.)
selbsterständlich	1) natural/natually/obvious/obvsiously/self-evident (Das ist selbstversdändlich.)
verstehen	1) to understand (Ich verstehe dich.)<div>2) to apprehend</div><div>3) to appreciate/to catch/to see/to grasp<br /><div><br /></div><div>related: selbstverständlich</div></div><div><br /></div><div>pret: verstand</div><div>part: verstanden</div>
begeistern	1) to delight<div>2) to inspire/to thrill</div><div><br /></div><div>pret: begeisterte</div><div>part: begeistert</div>
begeistert	1) exited/keen&nbsp;<div>2) delighted&nbsp;</div>
verfügbar	1) available/obtainable (Am zwei Uhrzeit du bist nicht verfügbar.)<div>2) disposable</div>
kein	1) no (as in 'no cars')<div><br /></div><div>indefinite determiner</div><div>kein/keine/kein</div>
keiner	1) (pronoun) nobody (Keiner ist zufrieden.)<div><br /></div><div>forms:</div><div>m: keiner</div><div>f: keine</div><div>n: keines/keins</div><div>p: keine</div>
eindeutig	1) clear/obvious/clearly/obviously (Das ist eindeutig keine Orange.)<div>2) distinct/unambiguous/definite</div><div>3) precise</div><div>4) decisive</div>
der Samstag	die Samstage<div>1) Saturday (Am Samstag schalfen wir lange.)</div>
das Weihnachten	1) Christmas (Weihnachten ist eine gute Zeit für deine Gesundheit)
die Gesundheit	(no plural)<div>1) the health (Deine Gesundheit ist wichtig.)</div><div>2) the wholesomeness&nbsp;</div>
antworten	1) to reply/to respond<div>2) to answer</div><div><br /></div><div>pret: antwortete</div><div>part: geantwortet</div>
kennen	1) to know (like conocer)<div>2) to recognize (know)</div><div><br /></div><div>pret: kannte</div><div>part: gekannt</div><div>kon1: kenne</div><div>kon2: kennte</div>
zwei	1) two
verletzen	1) to injure/to harm (Wer hat ihn verletzt?)<div>2) to offend</div><div>3) to breach/to violate</div><div><br /></div><div>pret: veretzte</div><div>part: verletzt</div>
verletzt	1) injured<div>2) violated</div>
gut	1) good<div><br /></div><div>det: guter / gute / gutes</div><div>comparative: besser / bessere / besseres</div><div>superlative: bester / beste / bestes OR am besten</div><div><br /></div>
das Schloss	die Schlösser<div>1) the lock (on a door/gun)</div><div>2) the castle (Sind sie in ein Schloss gegangen?)</div><div>3) the palace</div><div><br /></div>
sprechen	1) to speak / to talk / to converse<div><br /></div><div>pres: ich spreche / du sprichst / etw. spricht / wir sprechen / ihr sprecht / sie sprechen</div><div>pret: sprach</div><div>part: gesprochen</div><div>imper: sprich</div>
trinked	1) to drink (Wir haben alles Bier getrunken.)<div>2) to imbibe</div><div><br /></div><div>pret: trank</div><div>part: getrunken</div>
suchen	1) to seek (Ich habe es gesucht.)<div>2) to search / to hunt</div><div>2) to google</div><div><br /></div><div>pret: suchte</div><div>part: gesucht</div>
geschehen	1) to occur / to happen / to transpire (Was ist geschehen?)<div><br /></div><div>pret: geschah</div><div>part: geschehen</div>
mögen	1) to like (Er hat das sofa nicht gemocht.) (Ich mag den Apfel.)<div><br /></div><div>pres: ich mag / du magst / etw. mag / wir mögen / ihr mögt / sie mögen</div><div>pret: mochte</div><div>part: gemocht</div><div>kon1: mögt</div><div>kon2: möchte</div>
das Sofa	die Sofas<div>1) the sofa (Er liegt auf dem Sofa.)</div>
laden	1) to load (Hast du das schon geladen?)<div>2) to charge (give a responsibility)</div><div><br /></div><div>pret: lud</div><div>part: geladen</div>
der Schüler	die Schüler<div>1) the pupil</div><div>2) the student (school pupil)</div>
der Bäcker / die Bäckerin	die Bäcker / die Bäckerinnen<div><br /></div><div>1) the baker</div>
der Geschäftsführer	die Geschäftsführer<div>1) the manager</div><div>2) the CEO</div><div>3) the business executive</div>
der Verkäufer	die Verkäufer<div>1) the vendor</div><div>2) the salesman</div><div>3) the assistant</div>
der Arbeitgeber	die Arbeitgeber<div>1) the employer</div><div>2) the taskmasker</div>
der Schmuck	<div>die Schmucke</div>1) the jewelry<div>2) the trinket</div>
der Mitarbeiter	<div>die Mitarbeiter</div>1) the employee<div>2) the coworker&nbsp;</div>
der Lehrer	<div>die Lehrer</div>1) the teacher (Die Schule hat viele Schüler und Lehrer.)<div>2) the tutor</div>
das Quartal	<div>die Quartale</div>1) the quarter (e.g., of a year) (Dieses Quartal ist wichtig.)
die Jahreszeit	1) the season (Der Frühling ist eine Jahreszeit.)
monatlich	1) monthly (Wir bezahlen monatlich.)
seit	1) (prep) since (Seit Januar.)<div>2) (prep) for</div>
kosten	1) to cost (Was kostet das monatlich?)<div>2) to taste/to sample</div><div>3) to take (time)</div><div><br /></div><div>pret: kostete</div><div>part: gekostet</div>
allgemein	1) (adv) generally (Das ist allgemein richtig.)<div>2) (adj) generic</div><div>3) (adj) general</div><div>4) public</div><div>5) nationwide/globally/popularly/universal/universally</div>
plötzlich	1) (adv) suddenly (Plötzlich ich sehe dich.)<div>2) (adj) sudden</div><div>3) (adj) abrupt</div><div>4) (adv) abruptly</div>
sinnvoll	1) sensible/reasonable/rational (Der Stadtplan ist sinnvoll.)<div>2) useful</div><div>3) meaningful</div><div>4) suggestive</div>
wert	1) (adj) worth (Aber sind sie es wert?)<div>2) (adj) worthy</div><div>3) (adj) valued</div>
verantwortlich	1) (adj) responsible/accountable/liable<div>2) (adv) responsibly/accountably</div>
gemeinsam	1) (adj) common/mutual<div>2) (adv) together/collectively</div><div>3) (adv) mutually</div><div>4) (adj) concerted</div><div>5) (adv) concertedly</div>
bereit	1) (adj) ready/prepared/enabled<div>2) (adj) willing</div><div>3) (adj) poised</div><div>4) (adv) readily/promptly</div>
ausgezeichnet	1) distinguished<div>2) excellent/magnificent/perfect (The Beatles sind ausgezeichnet.)</div>
das Öl	1) the oil (Das&nbsp;Öl ist es wert.)
das Grau	1) the color grey<div><br /></div><div>(adj) grau (Der Hund ist grau.)</div>
das Hemd	<div>die Hemden</div>1) the shirt (Ich mag die Hemden.)
das Grün	1) the color green (Ich habe drei grünen Pferde.)<div><br /></div><div>(adj) grün</div>
das Haus	<div>die Häuser</div>1) the house (Unser Haus ist toll.)<div>2) the home</div>
bunt	1) colorful (Unser Haus ist bunt.)
die Katze	die Katzen<div>1) the cat (Die grüne Katze ist lustig.)</div><div>2) the feline</div>
das Braun	1) the color brown<div><br /></div><div>(adj) braun (Seine Augen sind braun.)</div>
der Saft	<div>die Säfte</div>1) the juce (Ich mag roten Saft nicht.)<div>2) the sap</div>
die Erdbeere	die Erdbeeren<div>1) the strawberry (Die rote Erdbeere ist süß.)</div>
das Licht	"1) the light (""Rotes Licht ist schön."")"
die Tomate	die Tomaten<div>1) the tomato (Ich esse eine rote Tomate.)</div>
das Papier	<div>die Papiere</div>1) the paper (Das Papier ist weiß.)
das Weiß	1) the color white<div><br /><div>(adj) weiß</div></div>
das Holz	<div>die Hölzer</div>1) the wood ()<div>2) the timber</div>
das Metall	<div>die Metalle</div>1) the metal&nbsp;
der Sand	<div>die Sande</div>1) the sand (Das ist kein Sand, das ist Holz.)
das Plastik	<div>(no plural listed)</div>1) the plastic
die Plastik	<div>die Plastiken</div>1) the plastic art/sculpture
die Mauer	<div>die Mauern</div>1) the wall<div>2) the mural</div>
die Wand	die Wände<div>1) the wall (Ich sehe eine Wand aus Glas.)</div>
der Beton	1) the concrete (Ist die Wand aus Beton?)
der Himmel	<div>die Himmel</div>1) the sky (Der Himmel ist blau.)<div>2) the heavens</div>
die Wolle	die Wollen<div>1) the wool</div><div>2) the fleece</div>
das Blau	<div>die Blau / die Blaus</div>1) the color blue (Das Wasser ist blau.)<div><br /></div><div>(adj) blau</div>
schwer	1) heavy/heavily<div>2) difficult</div><div>3) severe/severely</div><div>4) hard</div><div>5) powerful</div>
das Dach	die Dächer<div>1) the roof (Das Dach ist aus Glas.)</div><div>2) the vault</div>
das Glas	die Gläser<div>1) the glass (Das Glas ist bunt.)</div>
täglich	1) daily (Ich spreche täglich Englisch.)
die Zukunft	die Zukünfte<div>1) the future (Wir sind die Zukunft!)</div>
die Vergangenheit	die Vergangenheiten<div>1) the past (Seine Vergangenheit ist nicht so gut.)</div><div>2) the record [of a person]</div>
wöchentlich	1) weekly (Sie bezehlen wöchentlich.)
der Montag	1) Monday
der Dienstag	die Dienstage<div>1) Tuesday</div>
der Mittwoch	die Mittwoche<div>1) Wedesday</div>
inzwischen	1) meanwhile&nbsp;<div>2) since then (Inzwischen haben wir achtsehn Katzen!)</div><div>3) by now/then</div>
der Anfang	1) the start/the inception/the outset/the beginning (Von Anfang bis Ende.)
der Donnerstag	die Donnerstage<div>1) Thursday</div>
der Freitag	die Freitage<div>1) Friday</div>
der Sonntag	<div>die Sonntage</div>1) Sunday
ankommen	1) to arrive/to reach (Er kommt spätestens am Montag an.)<div>2) to appear</div><div>3) to approach</div><div><br /></div><div>pret: kam an / ankam</div><div>part: angekommen</div>
spätestens	1) (adv) at the latest (Ich komme spätestens am Freitag an.)
die Krankheit	<div>die Krankheiten</div>1) the disease/the illness/the sickness<div>2) the ailment/the affliction</div>
krank	1) ill/sick/diseased (Die Patienten sind krank.)<div>2) weird/bizarre</div><div>3) poorly/bad</div>
neu	1) new (Die Krankheit ist neu.)<div>2) recent</div><div>3) novel</div>
