la vara	"1) the rod (""En la antigüedad los maestros le pegaban con una vara en la mano a aquellos que se portaban mal."")<div>2) the stick (""Juegue con su perro, puede lanzarle una vara para que haga ejercicio."")</div><div>3) the baton (""El ministro de justicia portaba la vara con honor."")</div>"
el palo	"1) the stick (""En las fiestas, los niños esperan ansiosos su turno para pegarle con un palo a la piñata hasta romperla."")<div>2) the mast (""El palo mayor es el más alto del barco."")</div><div>3) the suit (cards) (""En la cartomancia el palo de oros se refiere a cuestiones monetarias."")</div><div>4) the club (golf) (""En el golf, cada palo solía recibir un nombre distinto pero ahora se usan números para identificarlos."")</div>"
taquear	1) to pack tightly<div>2) to fire</div><div>3) to play billiards</div><div>4) (mexico) to have a snack of tacos</div><div>5) (caribe) to dress in style</div>
el tapón	1) the plug<div>2) the cap/the lid</div>
colgar	to hang up
el sótano	1) the cellar/basement (Qué es una de las frases más bonitas en la lengua Inglés? Puerta del sótano.)
alcanzar	1) to reach/achieve
el taladro	the drill
parar	to stop (something that is moving)
aguantar	to endure
disponer	1) to arrange/order<div>2) to provide</div><div>3) to dispose</div>
la esquirla	1) the splinter
mismo/a/os/as	"1) intensifier (e.g., myself)<div>2) the same (very one)&nbsp;<span class=""Apple-tab-span"" style=""white-space:pre""> </span>(Ese es el mismo coche que me atropelló."")</div><div>3) the same (idential to) (Lleva un jersey del mismo color que sus ojos.)</div>"
la escobillón	1) the swab
la hoja	"1) the sheet (e.g., of paper or bedding) (""Ojalá que las hojas no te toquen el cuerpo cuando caigan.""<div>2) the leaf (from a tree) (""<span class=""Apple-tab-span"" style=""white-space:pre""> </span>La hoja de la navaja está muy afilada."")</div><div>3) the shutter (window) (""En este pueblo son típicas las ventanas pequeñas con una sola hoja de madera."")</div>"
hay que	“(it) must (be that) [verb/subject]” (“Hay que tirar la basura”)
tener que	“[subject] needs to” (“Alguien tiene que tirar la basura”)
empujar	to push/shove/poke
el petardo	the firecracker
prender	1) to turn on/light (ignite — light as a match/fuse)
el alcance	the scope/reach
fijar	to set/fix/pin up
el trozo	1) the piece (like pedazo and pieza)
la delantera	1) the lead/front
el galgo	the greyhound
arder	to burn
lanzar	1) to lance/throw like a spear (Juan estaba corriendo cuando, de repente, él lanzó delante hacia el perro.)
agachar	1) to duck<div>2) crouch</div><div>3) hunker down</div>
sorda/o	1) muffled (La voz fue sorda porque la estana atrás de una pared.)
la ráfaga	1) the blast/explosion
rozar	to scrape
raspar/rascar	to scratch
silbar	to hiss/whiz by/whistle
pálidos	"1) pallid/pale (like skin) (""Soy un chico muy pálido, tengo la piel blanca.""<div>2) pale/faint/feeble (""No se podía leer bajo la pálida luz de la vela."")</div>"
enterrar	to bury/entomb
castigar	to punish
dejar castigado	leave/make punished
acercar	to zoom in / draw nearer
humeante	smoky
todavía	1) still (prep)<div><br /></div><div>(yet???)</div>
aunque	1) although/in spite of (Aunque tuviera dos, yo solo quiero aquel.)
el montículo	the mound/knoll
suceder	to happen/occur
replicar	to answer/retort/reposte
sensato	1) sensible/reasonable (Esa razón es perfecto; tu eres un persona muy sensata.)
el desafío	the challenge/duel/dare
saber (preterite form)	sup-
saber (subjunctive form)	sep-
dar por hacer [algo]	1) to take to [something]<div>2) to feel like doing [something]</div><div>3) to be into [something]</div>
la destreza	the skill/dexterity
la rodilla	1) the knee (Cuando preguntas a su novia para casarse, no olvides bajarse en tus rodillas.)
el codo	"1) the elbow (""Me duelen los codos!!"")"
ensangrentar	to stain with blood
la caña	the cane/rod/small glass of beer
proseguir	1) to pursue<div>2) to prosecute</div>
evitar	to avoid/prevent/avert
tumbar	to overthrow/topple/tumble
por lo tanto	Thus/therefore
perder	to lose/miss/waste
el balde	the pail/bucket
llenar	"1) to fill (usually with 'de') (""Llena el tanque de gasolina cuando vayas a salir a carretera."")"
el yelmo	the helmet
el casco	1) the helmet<div>2) the fragment</div><div>3) the wedge</div><div>4) the empty bottle</div><div>5) the city center</div><div>6) the ship hull</div>
corregir	to correct/make right
sugerir	to suggest/prompt<div><br /></div><div>i --&gt; ie</div><div><br /></div><div>se conjuga como: sentir</div>
quedar acordado	to reach agreement
desarmar	1) to disarm ()
el peto	1) the breastplate/bib (Los jovenes estan armados con los petos de hierro.)
la ranura	the groove
el agujero	the hole
el taladro	the drill
coincidir	to coincide/to be at the same time/to agree
"""tienes razón"""	“You’re right”
huir	to run away/to flee
hallar	to find
el esclavo	the slave
ilusionar	1) to inspire hope
ilusionado	inspired with hope
soltar	1) to let loose/to set free
la sustancia	1) the substance/essence
discutir	to argue
consumir	1) to consume ()<div>2) to drink/to eat ()</div>
derretir	1) to thaw<div>2) to melt (La nieve derritió anoche a causaba del calor.)</div>
admitir	to accept/to admit
la magia	"1) the magic (""Quiero sentir la magia de tu olor."")"
el rincón	1) the closet (Qué se esconde en el rincón?)
acabar	1) to finish/to end (El domingo acaba el Tour de Francia.) (Los bomberos acabaron con los últimos focos del incendio.) (Los disgustos acabaron con su vida.)<div><br /></div><div>2) to orgasm/to cum ()</div>
jurar	to swear (an oath)
el/la amante	the lover
marchar	"1) to march (away) (""Te puedes marchar y no vuelvas jamás."")"
jamás	1) never/ever (Estamos acabado -- no vuelvas a mi jamás.)
acaso	1) perhaps, maybe (Obtener dinero puede parecer acaso una obsesión.)
perdonar	1) to forgive/to pardon (No te voy a perdonar.)
engañar	1) to trick/to fool/to deceive (¡Mentiroso! ¡Me has engañado!) (Las apariencias pueden engañar.)<div>2) to cheat on/to be unfaithful to (Juan engaña a su novia.)</div><div>3) to curb/to satisfy/to assuage (Engañaron el hambre con unas manzanas.)</div>
largar	"1) to tell/give<div>2) to deliver (""Lárgate!"" = ""deliver yourself away from here!"" / ""Scram!"")<div><br /></div></div>"
imprescindible	indispensable/esstial/irreplacable
el traidor / la traidora	the traitor/the betrayer
sustituir	to replace/to substitute
curar	1) to treat/to dress/to heal (Ya me curé del dolor.)
el asco	the nausea
lárgate!	“scram!/beat it!”
el daño	the damage/the harm
infeliz	unhappy
aquel / aquellos / aquella / aquellas	1) that/those
quejar	1) to complain/to gripe (Jaime nunca queja por nada -- él es de material fuerte y callado.)
confesar	1) to confess
el fondo	the bottom/the depth
separar	to separate
alejar	to move/get away from
el desierto	1) the desert
atrás	1) behind (No no, la persona que estoy hablando sobre está atrás esa persona.)
marcha atrás	the going back/reversal
pillar	to catch (as in catch a burglar or liar)
sabrosear	1) to have fun
moler	"1) to grind (""Antes de usar la canela, debes molerla."")"
“moliendo caña”	“grinding cane / having fun together but not necessarily having sex” (from colombia, grinding sugar cane)
el vallenato	the song? (colombia)
el llanero / la llanera	the plainswoman/the lone ranger
“viejos del alma”	“parents”
repartir	1) to hand out/to deliver (El jefe repartió más dinero a sus trabajadores para trabajo bueno.)
ajuiciar	to bring to one’s senses
el juicio	1) the trial<div>2) the judgment</div><div>3) the good sense</div>
casar	to marry
la pata	the leg (of an animal)/the paw
“meter la pata”	“to screw up”
“por poco”	“narrowly”/“almost”/“nearly”
el disparate	1) the crazy idea/absurdity
exprimir	"1) to squeeze/press (""Exprimió dos naranjas porque quería jugo para el desayuno."")<div>2) to wring (""Marta exprimió la camisa antes de colgarla."")</div>"
“salir ganando”	“ends up / emerges winning”
el dicho	the saying
“llegar a saber”	“to become known”
el tonto	the idiot
callado	1) quiet/reserved/silent (Muchas veces, gatos son muy callados.) (El aire es callado antes de tormentas.)
el hueso	1) the bone<div>2) the pit (of fruit) (Manzanas no tienen huesos, pero los tienen algunas tipas de uvas.)</div>
regatear	to haggle
“salir caro/a”	to turn out/end up being expensive
pues	"1) ""well, ...""<div>2) since (because)/then (because) (Q: ""Por qué quieres comprar mi novia?"" A: ""Pues me has dicho de ella y me gustó la información."")</div>"
lindo/a	beautiful/cute/sweet/excellent
apasionada	1) passionate
adinerada	wealthy/rich
celar	to get jealous
celoso	jealous
el vecino/la vecina	the neighbor/the resident
gastar	to spend/to use (time, money)
economizar	"1) to economize<div>2) to save (""Ella es buena con dinero; economiza y no gasta."")</div>"
resolver	1) to solve<div>2) to resolve (Su novia resuelve todo tranquila.)</div><div>3) to decide</div><div><br /></div><div>o --&gt; ue</div>
igualito/a	exactly the same
fabricar	to manufacture/to make/to produce
la mía	“my thing”/mine
toditito	absolutely all
meter	1) to put / to place into<div>2) to make noise</div><div>3) to score</div>
guardar	1) to keep<div>2) to put away</div><div>3) to save</div>
exigir	1) to require<div>2) to demand</div>
quedar	1) to remain/to be left/to have left (Sólo le quedan quinse dolores para terminar el mes.)<div>2) to be located (El hotel queda muy cerca de la estación.)</div><div>3) to arrange to met / to settle on (Mi hija y sus amigas quedaron a las seis en el cine.)</div><div>4) to suit / to fit (Te queda pequeña la frase 'te quiero'.) (El vestido verde te queda mejor que el rojo.)</div>
crecer	to grow/to expand
el paso	the step (like walking forward)
el gigante	the giant (also an adjective)
ahí	there/then
“Se fue complicando la stuación”	(noted for sentence structure) “The situation was becoming complicated”
la mentira	the lie
allá	over there/there
acá	over here/here/now
cruzar	to cross/to go across or through/to exchange/to bump into
el camino	"1) the road/the journey/the trip (""Ojalá las paredes no retengan tu ruido de camino cansado."")"
el valor	the courage/the bravery/the value/the validity
tan	"1) so (before adj, adv, participio) / such (before noun) (""La mochila es tan negro!"") (e.g., expressing consequence: ""Estaba tan perdido en sus pensamientos que no escuchó las pisadas que se acercaban."")<div>2) as (comparison) (""Está tan sordo como una tapia."")</div>"
desaparecer	1) to disappear/to vanish
merecer	to merit/to deserve
despedir	1) to emit<div>2) to lay off (La empresa despedió muchas personas mientras la economía se bajaba.)</div><div>3) to say goobye</div>
endulzar	1) to sweeten (Azucar endulza postre.) &nbsp;(Tu sonreír le endulza a mi día.)
confundir	1) to confuse/to confound ()
la sonrisa	1) the smile
el camelo	the hoax/the pack of lies/the con
el piel	the skin/the leather/the peel
la mezcla	1) the mixture/the blend<div>2) the mortar</div>
sed	thirst
el agua	the water
la caricia	the stroke/the caress
mimar	1) to indulge/to spoil/to pamper (Mi novia mima en viaje lujo todos sus vacaciones.)
reconomcimiento	the recognition/the award/the prize/the examination/the checkup/the reconnaissance
la ternura	the tenderness/the fondness/the affection
la corazón	the heart/the core
nacer	1) to be born/to originate/to have as a source (liquid) (El día que nazca tu hijo será el más feliz de tu vida.) (De un sueño que tuvo hace cinco años nació la idea para su primer libro.) (En la Inlgaterra y en Estados Unidos, el arte pop nació en la década de los cincuenta.)<div>2) to rise [above the horizon] (El sol nace por el Este.)</div><div><div><br /></div><div>se conjuga como: agradecer</div><div>participio tiene triple: nacido / nado / nato</div></div>
el amor	the love
tratar	to address (as in an author writing about an issue)/to treat/to deal with
tratarse de [algo]	to try to [do something] / to be about [something] (NOTE —  always conjugated in third person singular
bonito	1) nice/love/pretty/beautiful
el bonito	the tuna
la nube	the cloud/the billow/the swarm/the marshmallow
besar	to kiss/to graze (brush against)
la lona	the canvas/the tarp/the mat
volar	1) to fly (Volaré a Chicago en el diez y siete de Septiembre.)<div>2) to explode</div><div>3) to steal</div>
el olor	the smell/the odor/the scent
brillante	shiny/bright/sparkling/brilliant
el lucero	the bright star/the point of light/Venus
el labio	the lip/the rim/the edge
enamorar	1) to win [subject’s] heart/to make [subject] fall in love
haber	there is/there are — many conjugations
la espuma	the foam/the froth (head)/the bubbles/the lather/the scum/
subir	to climb/to go up/to mount/to board/to get on or into
comparar	to compare
especial	special/specialized
agradecer	1) to express gratitude for<div><br /></div><div>yo: agradezco</div>
imaginar	to imagine/to picture/to suppose
el sentimiento	the feeling/the emotion/the sentiment/the sense
el sentido	the sense/the meaning/the direction
puro	"1) pure (""Un amor puro y natural."")"
natural	natural/fresh/native
admirar	to admire/to contemplate/to be amazed or astonished (reflexive)
digno	worthy (syn. merecedor)/deserving/decent/respectable
la fantasía	imagination/fantasy
el romance	the romance/the affair
la alegría	happiness/joy
bello	beautiful/lovely (hermoso/bonito)
el nene/la nena	"1) the little child/the kid<div>2) ""baby,darling,honey"" (Nena quién lo diría que de ti yo me enamoraría y que sin tu amor no viviría."")</div>"
quién	"1) who (interrogative) (Quién es la más bonita?)<div>2) whom (accusative/dative case) (No sé quién ha cogido las llaves.) &nbsp;(Con quién estás hablando?)<br /><div>3) if only (como ojalá) (""Quién pudiera hacer ese viaje!"")</div></div>"
amar	to love/to be passionate about
la princesa	the princess
el cielo	"1) the sky (""Me siento en las nubes cuando tu me besas."")<div>2) the heavens</div><div>3) the angel/the delight/the marvel/God</div><div>4) the ceiling</div>"
la frase	the sentece/the phrase/the quotation/the saying
el pensamiento	the thought/the thinking/the dream/the pansy (color)
el temo	the fear/the dread/the concern
preciso	precise/accurate/necessary/essential
la atención	"1) the attention (""Los alumnos prestan poca atención al profesor."")<div>2) the service/the assistance (""Dirige tu reclamación al departamento de atención a clientes."")</div>"
la prisión	the prison/the prison sentence
libre	free/unoccupied/available
servir	to still be good/to be useful/to work (function)/to serve
“ya nada sirve que digas”	“it’s useless for you to say”
servir para	1) to be good at ()
la salida	1) the exit/the way out<div>2) the end/the release (Estoy un poco triste porque puedo ver la salida de esta parte de mi viaje.)</div><div>3) the trip/the journey</div><div>4) the starting line</div><div>5) the quip/the witty remark</div>
escapar	to escape/to evade/to pass up
acomplejar (a algn)	to give something a complex
acomplejarse	"to get a complex (con, por about) (""Pues tan pensamientos te acomplejas por tu trabajo."")"
el espejo	the mirror
el maquillaje	the make-up/the foundation
gordo	fat/overweight/plump
flaco	skinny/lean/lanky/not do someone any favors/put at a disadvantage
prometer	to promise/to pledge/to assure/to have promise
desear	to wish/to want/to desire (especially sexually)
rezar	1) to pray (Reza a dios!)<div>2) to recite</div>
la vela	the candle
"""en vela"""	awake
dedicar	to dedicate
blanquita	cracker/paleface/whitey
morenita	slang for dark-skinned?
morena	1) dark-haired/brunette<div>2) dark-skinned/brown/tan</div>
ni	nor (joins negatives)/not even (intensifier)
cortar	1) to cut (Cuando tu me miras se me corta la respiración.)
la respiración	the breathing/the respiration/the ventillation
mirar	to pay attention/to look/to watch
subirse	1) to go to [subject’s] head<div>2) to talk down to [subject]</div>
el silencio	"the silence (""Me gusta el silencio porque él dame tiempo para pensar."")"
el mil	the thousand
la palabra	"1) the word<div>2) the promise (""Mi palabra es mas duro que madera."")</div>"
suplicar	"1) to request/to beg/to plead (La noche en la que te suplico que no salga sol.) (""Ana, te suplico... no vayas. Piense de nuestros niños! &nbsp;Qué pasará a ellos?"" &nbsp;""Pero Jorge, no tengo tiempo para tus suplicos. &nbsp;Me engañaste por la última vez, y tu eres un traidor de corazón. &nbsp;Vete.)"
“salir el sol”	“the sun come up” / “the sun rise”
el vació	1) the vaccuum/the hole/the emptiness (El vació en Hueco Mundo es muy, muy grande y triste.)<div>2) the space (Mientras bailando, nos cuerpos están llenando el vació, subiendo y bajando.)</div>
enloquecer	1) to drive crazy
bajar	to take down/to drop/to fall/to get off/to disembark/to lower/to download/to bend down
saturar	to saturate/to flood (figurative)
la física	1) physics<div>2) physique</div>
la química	the chemistry
la anatomía	1) the anatomy ()
la cerveza	the beer
el tequila	the tequila
el color	the color
la cabeza	1) the head<div>2) the leadership</div>
filosofía	1) the philosophy ()
“ay”	“Oh!” / “Oh dear!” / “*groan*”
tremendo	terrible/awful/tremendous/enormous
llevar	1) to carry/to take (El botones llevó las maletas al dormitorio.)&nbsp;(El guía nos llevó por toda la ciudad.)<div>2) to spend&nbsp;&nbsp;(Ana lleva dos meses en Madrid.)</div><div>3) to bring/to lead to&nbsp;(Con sus despilfarros llevó a la familia a la ruina.)</div><div>4) to wear (Ana lleva el vestido azul porque es el que mejor le sienta.)</div><div>5) to be more than (En lo que va de la tarde, llevo corregidos veinte exámenes de mis alumnos.)</div><div>6) (refl) to steal/to swipe (El ladrón se llevó joyas y dinero.)</div><div>7) (refl) to get along/to hit it off (needs bien to be good) (Hay un buen ambiente de trabajo porque todos los empleados se llevan bien.)</div>
el latido	the beat
la dimensión	the dimension
acelerar	to accelerate/to get overexcited/to get worked up
la ironía	the irony
el destino	the destination/the destiny/the use (consumption of something)
tocar	1) to touch<div>2) to play (instrument)</div><div>3) to be someone’s turn</div><div>4) to win</div>
la melodía	the melody
“se me va [something]”	“it will bring me to [something]”
el dolor	1) the pain/the sorrow
tierna	1) tender/gentle/kind<div>2) early</div>
el cariño	1) the affection/the care (La semana pasada, compartía cariño con un mujer muy bonita.)<div>2) the cuddle</div>
“Se me olvidó el libro” / “Se le cayeron las plumas”	“The book got forgotten by me” / “The pens got dropped by him” (reflexive pronoun to indicate unplanned/accidental occurrence, conjugate to across with the direct object — compared to passive voice)
“Se olvidó el libro” / “Se cayeron las plumas”	
“Las plumas estaban caídos por mi” / “El libro está leído por ti”	“The pens were dropped by me” / “The book is read by you” (passive voice)
el milagro	the miracle
convertir	to change/to transform/to convert into
el cristal	the crystal
la lluvia	the rain
la luna	the moon
el cuerpo	the body/the corpse/the object/the thing/the squad/the team/the segment
la tierra	the land/the soil/the Earth
la mirada	the look/the way of looking
constante	"1) constant/continuous (""Ojalá se te acabe la mirada constante, la palabra precisa, la sonrisa perfecta."")<div>2) tenacious ()</div>"
perfecta	perfect/ideal
algo	"1) (pron) something (""Comieron algo en el restaurante."")<div>2) (adv) some/a little (""Juan sabe algo de francés."")</div>"
pasar	1) to go/to proceed (Al llegar pasamos directamente al comedor.)<div>2) to cross (Los refugiados pasaron el río en una balsa.)<br /><div><div>3) to pass (give)/to distribute/to sell/to transmit (La policía le detuvo por pasar droga.) (Pásame las patatas, por favor.)</div><div>4) to happen (Qué te ha pasado? Tienes cara triste.)</div><div><br /></div></div></div>
borrar	"1) to erase/to remove/to wipe off (""Ojalá pase algo que te borre de pronto"")"
“de pronto”	“suddenly”/“all of a sudden”
el disparo	1) the gunshot/the shot (El disparo seña la empieza de la corre.)
la nieve	the snow
la luz	1) the light (Durante la noche, las luces nos permiten ver.)<div>2) the electricity</div>
el segador / la segadora	1) the reaper (Ojalá que el segador no viena llevarme.)<div>2) the cellar spider</div>
“por lo menos”	“at least”
ver	1) to see (to perceive)<div>2) to see (meet)&nbsp;(Tienes fiebre; debería ver un médico.) (Nos vemos a la puerta del cina)</div><div>3) to examine / to look at (Ve esa herramienta -- no está funcionando)</div><div>4) to see (understand) (Ves lo que quiero decir? Me cuesta mucho explicar conseptos abstractos.)</div><div><br /></div><div>pretérito: yo vi / él vio</div><div>imperf: ve-</div><div>present: yo ve / vosotros veis / vos ves</div><div>perfecto: visto</div><div>pres sub: ve-(all)</div><div><br /></div><div>afirm: ud vea / nos veamos / uds vean / vos ve</div><div>neg: no ve-</div>
tanto	so long/so much/so many/point or goal (sport)
siempre	always
el segundo	the second
la visión	the vision/the view
“no puedo mas”	“I’ve had enough” / “I can’t go on” / “I cannot take it any longer” / (lit) “I can’t do more”
la muerte	the death/the murder/the destruction
“gran [noun]” vs “[noun] grande”	“great [noun]” vs “big [noun]”
“antiguo [noun]” vs “[noun] antiguo”	“former [noun]” vs “antique/old fashioned [noun]”
“nuevo [noun]” vs “[noun] nuevo”	“recently made [noun]” vs “unused [noun]”
“[subject’s] propio [noun]” vs “[noun] propio”	“[subject’s] own [noun]” vs “appropriate [noun]”
“pobre [noun]” vs “[noun] pobre”	“poor (pitiful) [noun]” vs “poor (without money) [noun]”
“solo [noun]” vs “[noun] solo”	“only one [noun]” vs “lonely [noun]”
“único [noun]” vs “[noun] único”	“the only one [of the noun]” vs “unique [noun]”
how to form an adverb	[singular feminine form of an adjective] —&gt; [add -mente]
special rule for two adverbs modifying same verb	only add “-mente” to the second (last) one
what tends to happen when an adverb precedes a verb?	the subject comes after the verb (“Siempre me decía mi madre que en la vida se recoge lo que se siembra”)
recoger	to pick up/to gather/to roll up/to fold/to go home (refl)
“lo que”	“(the same)/(it) which” (referring to something introduced earlier)
sembrar	1) to sow (Mi madre siempre dice que recibes lo que siembras.)&nbsp;<div><br /></div><div>(e —&gt; ie)</div>
when is it common for a subject to come after its verb?	1) some exclamations (“Cuántos errores cometió él!”), 2) when an adverb precedes the verb (“[Cuando era niño] [[adverbial phrase]] me maltrataron muchísimo mis padres”), 3) with verbs of existence (haber not in a perfect tense, existir) (“Solo hay dos opciones”) 4) to indicate the person speaking (“‘Eso está muy bien,’ contestó el Presidente”) 5) with verbs like gustar (this basically means “verbs that require dative object)
apasionar	to inspire/to be passionate about (como gustar)
encantar	1) to please/to bewitch/to entrance (“Me encanta viajar y conocer otras culturas”)
gustar	to please
faltar	to lack/to miss/to be lacking/to be missing (can be used like gustar “Si no faltara dinero en mi casa [si no le faltara dinero a mi casa], podríamos permitirnos algunos lujos”; can be used normal “Si faltas al trabajo con frecuencia, te van a despedir”)
el lujo	"1) the luxury/the opulence (""El lujo en el que vivían los reyes contrastaba con la miseria del pueblo.""; &nbsp;""Faltar al trabajo por capricho es un lujo que no podemos darnos."")<div>2) the comfort/the benefit (""Mi trabajo es un lujo, me hace sentir realizado.""</div><div>3) the abundance/the profusion (""Relató lo sucedido con todo lujo de detalles.""</div><div>4) the excess (""Los ladrones asaltaron la sucursal bancaria con lujo de violencia."")</div>"
sobrar	to be left over/to be too many (maybe like gustar sometimes? “Con el dinero que sobró de la boda se irán de luna de miel”)
aburrir	1) to bore/to tire
la charla	1) the chat/the chatter
monótono	monotonous/monotonic
fascinar	to fascinate (“Me fascina el color de sus ojos”)
bastar	1) to be enough/to be sufficient (“Me bastaron dos huevos para me sentir lleno.”)
importar	1) to matter/to be important (“Lo que más me importa son mis hijos”)
caer bien (mal)	to (dis)please (lit, “fall well (badly)”) (“Me caen bien sus acciónes simpáticos” o “Sus acciónes simpáticos me caen bien”)
interesar	to interest/to concern/to take an interest in (refl) (“Es una tema que le interesa profundamente”)
profundo	1) deep/profound ()
la tema	1) the matter/the theme/the subject/the (single) point (“En la reunión se tratarán various temas”)
la reunión	1) the meeting/the reunion/the gathering
molestar	1) to bother/to disturb/to hurt/to upset/to annoy (“Me molesta el ruido nocturno y no me deja dormir”)
disgustar	1) to upset<div>2) to annoy</div>
parecer	1) to appear/to seem (Juan parece inteligente hasta que abre la boca) (Me parece que vas demasiado rápido.)<div><br /></div><div>NOUN: el parecer -- the opion/the decision (Le preguntamos a mi padre su parecer sobre el viaje.)</div>
el gemelo	1) the twin<div>2) the calf muscle</div>
doler	1) to hurt/to ache (“A Jaime le duele la cabeza”)<div><br /></div><div>&nbsp;(o—&gt;ue)</div>
picar	"1) to sting/to bite (bee or mosquito) (""Las abejas pican si se las molesta."")<div>2) to bite/to take the bait (fishing) (""Los peces pican muy bien hoy."")&nbsp;</div><div>3) to grab a bite to eat/to grab a snack/to snack (""Al salir de la oficina vamos a picar algo por ahí."")</div><div>4) to break/to chip (like a stone) (""Los canteros egipcios picaban la piedra con herramientas de cobre."")</div><div>5) to grind/to mince/to chop/to crush (food) (""Le pedía al carnicero que picase la carne muy fina."")</div><div>6) to bother/to annoy (""No hagas caso de lo que te dice, sólo es para picar."")</div><div>7) to fall (for a trick/trap) (""Picó en la trampa como un tonto."")</div><div>8) to peck at (""Las palomas picaban las migas de pan."")</div><div>9) to goad/to poke/to prod (bullfighting) (""El picador picó el torro muy mal."")</div><div>10) to tasty spicy/to burn (taste of food) (""La salsa estaba deliciosa pero picaba mucho."")</div><div>11) to corrode/to rust through (""Hay que cambiar las tuberías que están picadas."")</div><div>12) to get annoyed (reflexive) (""Me piqué con el libro, no pude soltarlo hasta que lo terminé de leer."")</div><div>13) (mexico) to get hooked/to get intrigued (reflexive) (""Me piqué con el libro, no pude soltarlo hasta que lo terminé de leer."")</div><div>14) (spain) to turn sour (reflexive) (""Qué mal sabe este vino, debe haberse picado."")</div><div>15) to get choppy (the sea) (reflexive) (""Si el mar empieza a picarse, es mejor regresar a puerto."")</div><div>16) (spain) to shoop up/to inject (drug) (reflexive) (""Dice que lo hará, pero nunca dejará de picarse."")</div><div>17) to be moth-eaten (reflexive) (""Las pieles están picadas por la polilla."")</div><div>&nbsp;</div>"
la abeja	the bee
la tontería	the nonsense/the absurdity/the foolishness
deliciosa	1) delicious ()<div>2) delightful/lovely ()</div>
volver loco	to drive crazy/to infuriate (“Mi hija de dieciséis años me está volviendo loca”)
la luna de miel	the honeymoon
la miel	the honey
“ir de [something]”	“to go on [something]” (like a honeymoon) (“Vamos a ir de la luna de miel”)
hacer caso	1) to pay attention to/to take [subject] seriously (Mi hijo nunca hace caso de lo que le digo)
la aurora	"1) the dawn/the daybreak (literal and figurative) (""La aurora anuncia un nuevo día.""; ""Los problemas no deben ensombrecer la aurora del progreso."")"
el grito	"1) the shout/the yell/the scream/the cry (""Qué ha sido ese grito?""; ""Dale un grito que baje a cenar."")<div><br /></div>"
"""de gritos"""	"""give shouts"" (""Ojalá que la aurora no dé gritos que caigan en mi espalda"")"
caer	"1) to fall down/to collapse/to drop (literal and figurative (""El árbol cayó sobre la casa.""; ""Mis vacaiones caen en agosto."")<div>2) to fall off (""El cuadro cayó de la pared."")</div><div>3) to catch on (realize) (""Por fin cayó en lo que yo quería decir."")</div><div>4) to hang down/to drop down (""El flequillo le cae sobre la frente."")</div><div>5) to be (""La concina cae a la izquierda."")</div><div>6) (night) fall (""Subimos de la playa al caer la tarde"")</div><div>7) (refl) to be utterly / absolutely (""Armando se caía de guapo, todas sus amigas estaban locas por él."")</div><div>8) (refl) to go down (""No pude inscribirme hoy en la universidad porque se cayó el sistema."")</div>"
la voz	"1) the voice (real and grammatical) (""Ojalá que tu nombre se le olvide a esa voz.""<div>2) the word (grammar)</div>"
cansado	"1) tired, exhausted (""Estoy muy cansado porque llevo dos noches sin dormir.""; ""Está cansado de oír las quejas de su esposa."")"
la pared	"1) the wall (""Levantó una pared de piedra."")"
retener	"1) to hold prisoner (""El ladrón retuvo a dos clientes como rehenes."")<div>2) to retain (""Retiene en su memoria todos los detalles del encuentro."")</div>"
tras	"1) after (later in time, después de)<div>2) behind (detrás de) (""Juan se escondió tras la puerta."")</div><div>3) after (in search of) (""Juan no quiere a Ana; va tras su dinero.""; ""Ojalá que el deseo se vaya tras de ti."")</div>"
irse	"1) to leave/to quit (an activity)/to go away/to depart/to split (""Se fue del trabajo porque no aguantaba a su jefe."") (Por qué me has ido?)"
el deseo	"1) the wish/the desire (""Espero que se cumpla tu deseo de ser cantante."")<div>2) the sexual attraction (desire) (""La miró con ojos llenos de deseo."")</div>"
cumplir	"1) to accomplish/to achieve/to fulfill (""Cumplió con su palabra y dejó de beber."")<div>2) to turn/to reach (age) (""Su hijo complió tres años."")</div><div>3) (refl) to expire/to end (""Mañana se cumple el plazo que te dio tu padre para que consiguieras un trabajo."")</div><div>4) (refl) to go into effect/to be implemented</div>"
el gobierno	"1) the government/the administration (""El gobierno de la nación ha aprobado los presupuestos para el próximo año."")"
viejo	"1) old (""En 2007, Tomoji Tanabe fue designado por Guinness como el hombre más viejo del mundo."")<div>2) worn out (""Voy a cambiar mi coche viejo por uno nuevo."")</div><div>3) long-term/long-established (""El maltrato infantil es un viejo problema que sigue cobrando víctimas por todo el mundo."")</div>"
el difunto	"1) the body / corpse (""Todos los curiosos se reunieron en círcula a ver al difunto."")"
la flor	"1) the flower (""La rosa es mi flor preferida."")"
arrejarse	"1) to take a risk (""Ganar mucho, hay que arrejarte."")"
ceder	"1) to give up/to relinquish/to cede/to transfer (""Cede tu asiento en el autobús a ancianos o mujeres embarazadas."")<div>2) to give in/to yield (""No pierdas tu tiempo, no lograrás que ella ceda a tus súplicas."")</div>"
tampoco	"1) neither/nor/either (""Tampoco soy perfecto solo sé que te quiero a ti."")"
"""En lo que ir de [...]"""	"""So far this [afternoon/morning/etc]"""
adivinar	1) to discern/to glimpse/to devine (En su expresión él adivinó la tristeza que la embargaba.)<div>2) to guess (Adiviné la contraseña de tu ordenador, fue cuestión de suerte.)</div><div>3) to foresee/to predict (Los videntes son farsantes que fingen adivinar el porvenir.)</div><div>4) (refl) to be visible/to be discerned (En el Estado de México desde lejos se adivinan las siluetas de los volcanes Popocatépetl e Iztaccíhuatl.)</div>
la maleta	1) the suitcase/the bag (Sólo me permiten subir una maleta pequeña al avión.)
maleta	1) lazy (Es un estudiante maleta que nunca hace las tareas.)
"""hacer la maleta"""	"""pack the suitcase"" / ""pack your bags"""
el viaje	1) the trip/the voyage (En enero fuimos de viaje a Holanda.) (Tuve que hacer dos viajes para traer la compra.) (Escribió la canción durante un viaje provocado por LSD.)
el billete	1) the (dollar) bill (En el anverso del billete mexicano de cincuenta pesos aparece la imagen de José María Morelos y Pavón.)
la billete	1) the money/the cash (Armando se siente irresistible sólo porque tiene billete.)
la ida	1) the departure / the going away (Compré sólo el billete de ida porque no sabía cuanto tiempo me iba a quedar allí.)
ida	1) (adj) crazy/nutty/miles away (distracted) (No hagas caso de lo que dice, desde que tuvo el accidente está ida.)<div>NOTE: la ida is 'the going/the departure', so can think of this a slang 'he's gone in the head')</div>
enojar	1) to anger/to make [sb] sad/to piss off (La mala calidad del sonido enojó a los fans de los Stones.)<div>2) to annoy/to upset (Los embotellamientos enojan a los conductores.)</div>
enojarse	1) (refl) to get angry/to boil over (Jorge se enojó porque le hicieron una broma pesada.)<div>2) to split/to break up (Se enojaron a causa de la madre de él.)</div>
a causar de / por causa de	1) because of / due to ()
a causa de lo cual	1) therefore/for that reason ()
la alma	1) the life and soul/the heart/the spirit (Es el alma de la fiesta.) (Pon un poco más de alma en la tarea.)<div>2) the soul (Después de morir, tu alma irá al cielo.)</div><div>3) the person/the individual (A la inauguración no asistió ni un alma.)</div>
el enfado	1) the annoyance/the irritation (Agarró un enfado mayúsculo cuando la grúa se llevó su coche.)
"""por mas que"""	"""however much"""
el lado	1) the side (Tiene un arañazo en el lado izquierdo.) (Nos sentamos al lado del río.) (No escribas en un solo lado del folio sino en ambos.) (Trabajar en casa tiene una lado malo y un lado bueno.)<div>2) the place (Este bar no me gusta, vámonos a otro lado.)</div>
el desengaño	1) the disappointment/the disillusionment (Cuando se dio cuenta de que su mujer le engañaba sufrió un gran desengaño.)
engañarse	1) to fool yourself / to deceive yourself (Quien piense que el fin justifica los medios se engaña a sí mismo.)
la aventura	1) the advenure (Cuando salimos, ni nos imaginábamos la aventura que nos esperaba.)<div>2) the venutre (Creo que estás corriendo muchos riesgos y que esta aventura podría salirte muy cara.)</div><div><br /></div><div>3) the fling/the affair (Tuvo una aventura con la muchacha pero aquello no duró mucho.)</div>
olvidar	1) to forget (He olvidado su número de teléfono.)<div>2) to not remember to do (El alumno olvidó traer los libros a clase.)</div><div>3) to cease to think of (Nunca olvidaré a los amigos de mi infancia.)</div>
olvidarse	1) to leave (not remember to take) (Siempre se te olvida el paraguas en casa.)<div>2) to forget about (La empresa se olvidó de la importancia de la seguridad.) (Los inquilinos se olvidaron de pagar el recibo de la luz.) (El pueblo nunca se olvidará de sus héroes.)</div>
el orgullo	1) the pride/the self-satisfaction/the vanity/the arrogance (El éxito profesional de su hijo le llena de orgullo.) (El orgullo le impidió disculparse.)<div>2) the self-respect/pride (good) (El orgullo de Brasil es su equipo de fútbol.) (Es un hombre íntegro, lo perdió todo pero conservó su orgullo.)</div>
el herido	"1) the wounded/the injured (""Trasladaron al herido en helicóptero haste el hospital."")"
herido	"1) wounded (""Un hombre herido en su amor propio no perdona las ofensas con facilidad."")"
valer	1) to cost/to be worth (El coche que quiero vale 20 mil euros.)<div>2) to be good at (No valgo para este trabajo)</div><div>3) to be good for/to work for (Un martillo no vale para atornillar.)</div><div>4) to be fair exchange for/to deserve (París bien vale una misa, dijo un rey.)</div>
vale (interj)	"1) (españa) fine, right, good (""Vale, quedamos mañana a las ocho."")"
valerse	1) to make use of / to take advantage of (Se valió de sus influencias para aprobar el examen.)
el pasado	1) the past (En el pasado solíamos juntarnos todos los sábados, pero ya hace tiempo que no lo hacemos) (Es necesario recordar el pasado para no repetir los errores.)<div>2) (grammatical tense) past (El pasado sitúa la acción del verbo en un momento anterior al presente.)</div>
pasado	<div>(adj)</div>1) relating to a previous time (Para pensar que todo tiempo pasado fue mejor, hay que tener más de 40 años.)<div>2) old-fashioned/behind the times (Ese peinado está muy pasado. Así se peinaba mi abuela.)</div><div>3) overcooked (Este arroz está pasado. Parece una pasta sin forma.)</div>
pasarse	(refl)<div>1) to pass over to/to go over to ()</div><div>2) to pass (transmit) (El maestro sacó a Manuel y a Juan del salón porque se pasaban recados durante la clase)</div><div>3) to forget (Se me pasó hablarte por teléfono para invitarte a la fiesta.)</div><div>4) to miss (Se me pasó un detalle importante al principio de la película, por eso no entendí el final.)</div>
parecerse	(refl)<div>1) to be alike/to look alike (Esos gemelos no se parecen en nada.)</div>
dentro	(adv)<div>1) inside/in/within (El colchón está podrido por dentro.)</div>
el precio	1) the price/the rate/the cost (El precio del petróleo se disparó en el último trimestre del año.) (Obtendré mi título de doctor a cualquier precio.)
preciar	1) to value/to appreciate (Yo precio tu amistad pero no me pidas ese favor.)
preciarse	1) to pride [yourself] in [something] (La maestra se precia de saber cuando los alumnos le mienten.)
pagar	1) to pay (Pagué quinientos pesos por esta blusa.) (Mañana pagaré el primer abono del préstamo.) (Si pagas a tiempo la luz, no te cortarán la electricidad.)<div>2) to pay back for bad treatment (fig) (No pagues a nadie mal por mal; es mejor saber perdonar.)</div><div>3) to atone for something (Pagué caro el error de haberte contratado como mi asistente.)</div><div>4) to repay for good treatment (Te pagaremos como te mereces si traes pistas sobre el asesino.)</div>
la cama	1) the bed (La habitación del hotel tenía dos camas en lugar de unda matrimonio.)<div>2) the trampoline (En la fiesta tuvieron mucho éxito las camas elástias.)</div><div>3) the hospital bed (El hospital cuenta únicamente con 300 camas.)</div>
sin	1) without (Me gusta el café sin azúcar.)
rencor	1) resentment (Guardar rencor envenana el alma.) (Deja todo en la cama y hablame sin rencor: si yo te hice daño te pido perdon.)
pedir	1) to ask for / to request / to order (El niño pidió agua a su madre.) (He pedido varios paquetes de semillas por internet.) (No he comprado el piso porque piden demasiado dinero por él.)<div>2) to demand / to expect (El direftor pide punctualidad a sus empleados.)</div><div>3) to need/to want/to cry out for (Estas paredes están pidiendo una mano de pintura.)</div>
traicionar	"1) to betray/to cheat on/to dupe (Traicionó a su novia con otra.) (Sus socio le traicionó y vendió todas sus ideas a la competencia.)<div><br /></div><div>2) to let down / to fail someone / to get the better of (Los nervios lo traicionaron y falló el gol.)</div><div>3) to give away (""your eyes betray you"") (Sus ojos le traicionaron; supe que me mentía porque no me miraba nunca.)</div>"
acabarse	(refl)<div>1) to end/to finish (Hasta que se acabe el proyecto no sabremos si tuvieron éxito los cambios en la empresa.)</div><div>2) run out (of) (Ayer se acabaron los boletos para rifa de la camioneta nueva.)</div><div>3) to lose (No quiero volverte a ver! &nbsp;Tus mentiras hicieron que se acabara la confianza que le tenía.)</div><div><br /></div><div>4) to orgasm/to cum</div>
venir	1) to arrive/to come (El director vino tarde.) (Estaban pavimentando la calle y se vinieron las lluvias.)<div>2) to return/to come back (Los pescadores vinieron de madrugada con una gran pesca.)</div><div>3) to be on/to be in/to appear (El artículo que te dije viene en la página 20.)</div><div>4) to orgasm/to cum (Rosa sospecha que es frígida porque nunca se ha venido)???</div><div>5) to settle (dispute)/to settle for [something]</div><div><br /></div><div>6) to get/to develop (Le vino un cáncer fulminante y se murió.)</div>
línea	1) the line (La recta es la línea más corta entre dos puntos.)<div><br /></div><div>2) the line of communication/transportation (La línea férrea está cortada.) &nbsp;(Tras la tormenta, estuvimos 2 días si línea. &nbsp;Menos mal que los móviles funcionaban.)</div><div>3) the transport route (Hoy se realiza el primer viaje de la nueva)</div><div>4) the figure (Estoy guardando la línea para ponerme biquini este verano.)</div><div>5) the (musical) line (En clave de sol, la nota en la cuarte línea es 're'.)</div><div>6) the line of writing (La redacción debe tener al menos 30 líneas y 300 palabras.)</div><div>7) the betting line (El premo por línea es 5 euros y por bingo, 25.)</div><div>8) the line of products (La compañia sacó una nueva línea de móviles que tuvo mucho éxito.)</div>
el coraje	1) the courage/the bravery/the guts (Por fin reunió el coraje para enfrentarse a su padre.)<div>2) the anger/the rage/the fury (Me da coraje tener que hacerle yo todo el trabajo.)</div>
pastar	"1) to graze (""Me unicornio azul ayer se me perdió -- pastando lo deje y desapareció."")&nbsp;"
cualquier	1) any<div>2) whatever/whichever (Si tengas información sobre la accidente, dime ahora.)</div>
la información	1) the information (Intentó reunir toda la información posible sobre su enfermedad antes de hablar con el médico.) &nbsp;(Guardamos toda la información en los disquetes del ordenador.) (Para tu información, ya he hablado con ella.)
dejar	1) to let/to allow (Su jefe dejó salir antes del &nbsp;trabajo.)<div>2) to leave/to abandon (Mi novio desapareció. &nbsp;Las flores que dejó... no me han querido hablar.)</div><div>3) to stop/to let up (with de) (Por fin dejó de llover.)</div><div>4) to lend (No le dejes diner a Juan, nunca lo devuelve.)</div><div>5) to let alone (Déjame, estoy trabajando.)</div>
dejarse	1) to let [subject's self] go (Cuando Luisa tuvo a su décimo hijo se dejó por completo.)
el unicornio	1) the unicorn (El unicornio se representaba normalmente como un caballo blanco con un cuerno en la frente.)
extraviar	1) to misplace/to lose (Yo perdió mis llaves. &nbsp;No sé si se me fueron o si las extravió.)
rogar	1) to beg/to plead (suplicar) (Rogó a su padre que la dejara ir a la fiesta.) &nbsp;(Si alguien sabe de mis llaves, le ruego información.)<div><br /></div><div>o--&gt;ue</div>
la amistad	1) the friendship (Mi unicornio y yo hicimos amistad, un poco con amor, un poco con verdad.) (No hay nada más bonito que la amistad entre un niño y su perro.)
el cuerno	1) the horn (El rinoceronte de Java sólo tiene un cuerno en el extremo de la nariz.)
añil	1) indigo (La casa pintada de añil confudía con el cielo del atardecer.)
pescar	1) to fish (No me gusta ir a pescar. &nbsp;Me da mucha rabia cuando veo que todo el mundo pesca algo y yo no.)<div>2) to catch (get sick) (Si no cierras esa ventana, vas a pescar un resfrío.)</div><div>3) to get/to hook (Pues la que menos creíamos pescó novio antes que todas las demás.)</div><div>4) to catch (in the act) (Los pesqué comiéndose el queque que era para Fabiola.)</div><div>5) to catch on to the idea (Algo me había mencionado él pero en ese momento no pesqué la idea.)</div>
saber	1) to know<div>2) to taste (have a flavor)</div><div><br /></div><div>pret: sup-</div><div>fut: sabr-</div><div>pres sub: sep-</div><div>past sub: sup</div><div>fut sub: sup</div><div><br /></div><div>neg comm: sep-</div><div>pos comm: sabe/sepa/sepamos/sabed/sepan/sabé</div>
compartir	1) to share (Juan comparte piso con otros estudiantes.) &nbsp;(El niño compartió el almuerzo con sus compañeros.)
la vocación	1) the vocation (Nerón tenía vocación de incendiario.) &nbsp;(Su vocación le llevó a irse de misionero a un país africano.)
la obsesión	1) the obssession/the compulsion (Tenía obsesión por comprar manteles de color azul.)
ayer	1) (adv) yesterday (No he comido nada desde ayer.)<div>2) past/yesteryear (Está siempre rememorando el ayer.)</div>
la maza	1) the mace/the club (El caballero se entrenaba con una maza llena de pinchos.)<div>2) the tenderizer (Para ablandar la carne el carnicero la golpeaba con una maza.)</div><div>3) the drumstick (Sujetaba la maza con la mano derecha y golpeaba el bombo con entusiasmo.)</div><div>4) the club/the juggling club (La gimnasta dejó caer una maza y fue penalizada por los jueces.)</div>
el cantador	1) folksinger, singer of popular songs (Silvio Rodrígues es un cantador.)
la cantera	1) the quarry (La cantera de mármol, que se encuentra en las afueras del pueblo, produce mucho polvo.)<div>2) (fig) the source / the reserve of young players / the young blood (La cantera del Real Madris es excepcional.)</div>
el resplandor	1) the brightness/the light/the radience (El resplandor de la mañana entra por la ventana.)<div>2) the shine/the glitter (No besamos al resplandor de la luna.)</div><div>3) the flash (of light) (El resplandor de la hoja de la espada me cegó memntáneamente.)</div><div>4) the splendor/the glory (El rey se visitió en todo su esplendor.)</div>
la montada	1) the small sandwich / the snack (Me tomé un montado y una cerveza como aperitivo.)<div>2) (adj) mounted / cavalry (Hay una guardía montada en la alcaldía.)</div>
el aplauso	1) the applause / the praise (El actor recibió un gran aplauso al terminar el primer acto.) &nbsp;(Su acción merece el aplauso y reconocimiento general.)
la copa	1) the glass/the wineglass (Compré una copa de cristal de Murano para mi colección.)<div>2) the drink/the cocktail (Tras la boda tomamos una copa en el restaurante del hotel.)</div><div>3) the cup (Podéis ganar la liga y podéis gana la copa si trabajáis duro.) (No me gustan los sujetadores de copa rígida.)</div><div><br /></div><div>4) the top or crown of a tree (El gato trepó a la copa del árbol.)</div><div>5) the top or crown of a hat (Los sobreros de copa alta y ancha forman parte del imaginario popular de la burgeusía.)</div>
la locura	1) the insanity/the madness/the dementia (La locura es una enfermedad.)
la garganta	1) the throat/the neck (La garganta es un conducto por donde pasan alimentos, líquidos, y aire.)<div>2) the gorge/the ravine/the canyon (Disfrutó de hermosas vistas mientras hacía senderismo por la garganta.)</div><div>3) the mountain pass ()</div>
el sinsonte	1) (Mexico, Central America) the mockingbird (El sinsonte es un buen cantador.)
el monte	1) the hill (Ese monte es muy alto pero no llega a la categoría de montaña.)<div><br /><div>2) the vegetation/the forest (El incendio arrasó varias hectáreas de monte.)</div></div>
esconder	1) to hide/to conceal/to disguise (Esconde los bombones; que no los vea tu madre.) &nbsp;(Los piratas escondieron tan bien el tesoro que nadie lo ha econtrado aún.) (No escondía su xenofobia.)
esconderse	<div>1) to be hidden/to be tucked away/to be kept out of sight (Nos escondimos de nuestros enemigos en el bosque.) &nbsp;(Detrás de su belleza se esconde la fealdad de su alma.) &nbsp;(En sus cuadros se escondía su amargura.)</div>
la pavura	1) terror (miedo/susto) &nbsp;(Con la noche viene la pavura.)
el trino	<div>1) the (musical) call / the song (Es bello escuchar el trino de las aves por la mañana.)</div><div>2) the trinity (Según católicos, Dios es uno y trino a la vez.)</div><div>3) the trill (Así es como se simplifica la ejecución del trino.)</div>
la razón	1) the reason (cause) (Juan desconoce la razón por la que le han despedido.)<div>2) the reason/reasoning (Mucha gente prefiere obedecer los mandatos del corazón y no los de la razón.)</div>
el equilibrio	1) the equilibrium / the balance / the harmony (Está en equilibrio y no hay peligro de que caiga.) (El equilibrio de sus facciones le have parecer muy bella.) &nbsp;(Mantenía el equilibrio sobre las puntas de sus pies.)
la balanza	1) the weighing scales / the balance (La balanza indicaba que el melón pesaba 20 kg.) &nbsp;(La balanza se ha inclinado a favor del matrimonio gay en Francia.)
el delirio	1) the delirium (Los delirios del enfermo eran provocados por la fiebre.)<div>2) the delusions/the crazy ideas (Desde que lo conozco no hago caso de sus delirios.)</div>
la esperanza	1) the hope (La fe, la esperanza, y la caridad son virtudes teologales.)<div>2) the expectation / the confidence (Tengo la esperanza de que todo salga bien.)</div>
agenciar	1) to promote / to arrange / to negotiate (Agencié las detalles del contrato para la fiesta.)
el sonido	1) the sound (Produce un sonido tan agudo que el oído humano no le percibe.) (El sonido de la 'rr' es vibrante.) (Están ajustando el sonido al desarrolo de la escena antes de publicar el video.)<div>2) the tone (Nunca olvidaré el sonido de su voz.)</div>
creer	1) to believe in / to have faith in (Tú podrás oponerte y todo lo que quieras pero yo sí creo en la gente.)<div>2) to think / to believe (have uncertain knowledge, but indicative) (Creo que Juan está de vacaciones.) (La vi tan delgada que creí que estaba enferma.)</div><div>3) to swear by (Tienes que actuar con convicción y creértela.)</div>
el amasijo	1) the jumble/the hodgepodge (Trase el choque, el auto quedó hecho un amasijo de metal y plástico.)<div>2) the kneading (Todos los reposteros intervienen en el amasijo.)</div>
cuerdo	1) (adj) sane/rational (No me digas loca, estoy más cuerda que tú.) (Le entró la locura durante unos días, pero ya está cuerdo.) (Mi jefe es un tipo cuerdo, no actúa sin reflexionar antes.)
la cuerda	1) the rope (Cogieron una cuerda y se fueron a saltar a la comba.)<div>2) the cord/the string/the thread) (Ataron el paquete con una cuerda.) (La cuerda es la parte con forma de hélice con la que se enroscan los tornillos.)</div><div>3) the (music instrument) string (Los violines y las guitarras tienen cuerdas.)</div><div>4) the bowstring (Tensa la cuerda del arco antes de disparar la flecha.)</div>
el corazón	1) the heart (organ) (Me gusta escuchar los latidos de tu corazón.)<div>2) the heart (figurative) (Cuando se despidió de nosotros en el aeropuerto, nos dijo que nos llevaba a todos en el corazón.) (Quítale el corazón a las manzanas y rellénalas de azúcar.)</div>
el tendón	1) the tendon (Se torció el tobillo y se le hinchó el tendón.)
el revoltijo	1) the jumble/the mess/the mishmash (No era fácil imponer unas normas a seguir en aquel revoltijo de costumbres.)
el carne	"1) the meat (Estoy a dieta, sólo puedo comer carne blanca.)<div>2) the beef</div><div>3) the flesh (of person or fruit) (La expresión ""la carne es débil"" se usa para refrirse a la flaqueza humana.)</div>"
la madera	1) the wood (La madera es una materia prima que se utliza mucho en la industria.)
mejor	1) (adj) better/best/top/highest (El Ferrari es mejor que el Renault.)<div>2) (adv) better/advisable (Mira, mejor dejarlo porque no merece la pena.)</div>
el instrumento	1) the musical instrument (La guitarra es un instrumento de cuerdas.)<div>2) the tool (Contaba con muchos instrumentos en su caja de herramientas.)</div><div>3) the machine (La fresadora es un instrumento para el labrado de los metales.)</div><div>4) the resource (Cuenta con más de un instrumento para llevar a cabo se cometido.)</div>
las lucecitas	1) fairy-lights (Las lucecitas son hermosas, pero es muy raro verlas porque aquellos quién las hacen son muy timidas.)
la escena	1) the scene (Desde mi butaca veía perfectamente la escena donde el mago hacía desaparecer a su ayudante.)<div>2) the stage (Se bajó el telón sobre la escena.)</div>
el testaferro	1) the front/the dummy (company or person) (El traficante de armas utilizó un testaferro para blanquear el dinero.)
el traidor	1) the traitor (Lo juzgaron como traidor a la patria.)
traidor	1) (adj) untrustworthy / treacherous (Es un perro traidor, no te confíes que te puede morder.)<div>2) (adj) false/fake (Le dio un abrazo traidor.)</div>
el servidor	1) the server (information tech)&nbsp;(Los datos se almacenan en el servidor.)<div>2) the servant (El rey enviaba sus mensajes con un servidor de toda su confianza.)</div>
el eternizador	1) the perpetuator (Tu eres un eternizador de melancólia y tristeza, y así te despido.)
eternizar	1) to perpetuate ()<div>2) to drag out ()</div>
eternizarse	1) (thing) to drag on forever<div>2) (person) to take ages (Se eterniza cada vez que va de compras.)</div>
el dios	1) god (Osiris era el dios de los muertos.)<div>2) (fig) god (Es un dios de la pantalla grande.)</div>
el ocaso	1) the sunset (El ocaso es el instante que corresponde a la desaparición del Sol en un horizonte hipotético.)<div>2) the decline/the twilight (En el ocaso de su carrera consiguió el triunfo que siempre había deseado.)</div>
jubilar	1) to get rid of something / to retire / to ditch)(Son mis zapatos favoritos pero los pobres están ya para que los jublie.)
jubilarse	1) to retire (from work) (Mi padre está a punto de jubiliarse.)
hervir	1) to boil liquid (El agua está hirviendo, prepara el té.)&nbsp;(Pon a hervir las patatas y las judías que es casi hora de cenar.)<div>2) to figuratively boil/roast (El volante del coche estaba al sol y está hirviendo.)</div><div>3) to swarm with/to seethe with (La ciudad hervía de gente moviéndose de un lado para otro.)</div>
el trapo	"1) the rag / the cloth (Puedes sacar brillo al coche con este trapo viejo.) (Seca los platos con un trapo limpio.)<div>2)&nbsp;""the limp rag"" (Me quedé como un trapo tras la excursión por la montaña.)</div><div>3) ""the sail"" (""El desplazamiento seguro de un velero depende de llevar el trapo adecuado para las condiciones del viento.)</div>"
lentejuela	1) the sequin (El vestido de lentejuelas era el más bonito de la fiesta.)
la cosa	1) the thing (Trajo un montón de cosas de su viraje al extranjero y las repartió entre sus amigos.) (He visto cada cosa tan rar en mi vida que ya nada me sorprende.)<div>2) the situation (Cuando estalló la guelga en la fábrica, la cosa se puso fea.)</div>
duro	1) (adj) hard/tough/stiff (El diamante es un material natural y muy duro.) (Bogard hacía papeles de tipo duro.) (El manubrio de la bicicleta no gira bien; está muy duro.)<div>2) (adv) hard (El boxeador pegó duro a su rival.)</div>
durar	1) to go on for / to last (La película dura nada menos que cuatro horas.)<div>2) to exist / to be still standing (La vieja concina de tu madre aún dura.)</div>
rondar	1) to circle (Las moscas rondaban la basura.)<div>2) to wander around / to loiter (La policía arrestó al hombre que rondaba la casa con malas intenciones.)</div><div>3) to pester / to badger (Ronda a su jefe desde hace días porque quiere un aumento de sueldo.)</div><div>4) to come on/to apprach (Creían que la muerte rondaba al pueblo y se negaban a rendirse sin luchar.)</div><div>5) to patrol (El vigilante ronda el barrio para impedir que se cometan robos.)</div><div>6) to go around/to bother (Una duda ronda por mi cabeza y no me deja dormir.)</div>
cada	1) each / every (El etrendaor dio un balón a cada judador.) (Juan va al médico cada ocho días.)<div><br /></div><div>2) (adj) such (Juan tiene cada choche!)</div>
la herida	1) the wound (Aún está abierta la herida que me causó tu abandono.) (El paciente llegó con una herida de bala.)
quien	1) (pron) who (Quien sepa la respuesta, obtendrá un premio.)<div>2) nobody (No hay quien entienda ese problema.)</div>
el hermano	1) the brother (sister if feminine) (La herencia se repartió entre los tres hermanos.)<div><br /><div>2) the mate for the pair (Qué rabia, no encuentro el hermano de este calcetín.)</div><div>3) the bretheren ()</div></div>
hacerse	1) to get used to / to accept&nbsp;(Es muy difícil hacerse a la idea de la muerte de un ser querido.)<div>2) to move / to move over (Hazte a un lado, que estorbas.)</div><div>3) to pretend to be (make believe) (Pudo sobrevivir al ataque del oso gracias a hacerse el muerto.)</div>
hacer	1) to make (cause) (Los chistes de un buen comediante hacen reír a la gente.)<div>2) to do / to carry out (Ana hizo los deberes.)</div><div>3) to make (prepare) (El panadero hace pan.)</div><div>4) to make (acquire, win) (Su padre soñaba con hacer fortuna en el extranjero pero regresó derrotado a su país.)</div><div>5) to say (as an animal / sound) (El gato hace miau.)</div><div>6) to take (time) (El autobús hizo ocho horas de Tampico a la Ciudad de México.)</div><div>7) to do (cover) (Los nadadores hacen cuatro kilómetros diarios.)</div><div>8) to turn (age) (Hoy Juan hace los tres años.)</div><div>9) to think/suppose/imagine (Yo te hacía de vacaciones.)</div><div>10) to be (time, weather) (Hoy hace mucho viento. Ayer hizo calor por la mañana.)</div><div>1) time (ago) (Hace cinco años se casó mi hermano.)</div>
la vida	1) the life (Las plantas tienen vida, las piedras no.)<div>2) the lifespan (La vida del perro es muy corto.) (Actualmente, los electrodomésticos tienen una vida muy corta.)</div><div><br /></div><div>3) the lifestyle (Juan se gana la vida como profesor.)</div><div>4) the life/activity (Esta calle tiene poco vida, apenas se ve gente.)</div>
escuchar	1) to listen to (Juan está escuchando música.)<div>2) to heed/to pay attention to (Si no escuchas a tu madre acabarás mal.)</div>
escucharse	1) to listen to [yourself] (Es un pedante, sólo habla porque disfruta escuchándose.)
dolerse	1) to take offense / to be offended / to be hurt (Se dolió cuando le dijeron que ella no estaba invitada.)
quedarse	1) to stay / to remain (Quédate aquí un momento, que voy al banco.) (Esta vacaciones no quedamos en un hotel.)
luchar	1) to fight / to struggle (Los enemigos lucharon hasta el final.) (Los ingestigadores aún están luchando para econtrar un vacuna.) (Mani Pacquiao luchará esta noche contra un boxeador español.)
aún	1) (adv) still (todavía) (Son las diez de la noche y tu hermano aún no ha llegado.)
aun	1) (adv) even (incluso) (Le daré un par de bofetadas, y aun tres como no esté en casa a su hora!)
el hierro	1) the iron (metal)<div><br /></div>
aburrirse	1) to become bored (refl)&nbsp;(“Su charla monótona me aburre.”)
disgustarse	1) to get annoyed<div>2) to get upset (“No le disgustes, mejor que no sepa la verdad”)</div>
amanecer	1) to begin to get light &nbsp;(En verano amence antes.)<div>2) to awake (Ayer amecimos muy cansados.)</div>
el amanecer	1) the sunrise / the daw (Me gusta madrugar para ver el amanecer.)
el pueblo	1) the village/the town (Es un pueblo pintoresco habitado por artesanos prodigiosos.)<div>2) the people (of a region/nation) (El pueblo tibetano tiene antiguas tradiciones.)</div>
el mar	1) the sea/the ocean (Para bañarme en el mar, prefiero el Mediterráneo.)<div><br /></div><div>NOTE: can be feminine in poetry and in certain regions</div>
después	1) (prep) after (Después de comer salimos a pasear.)<div>2) (adv) after/past (Yendo al sur, Toledo está después de Madrid.)</div><div>3) (adj) after/later (Llegamos a Madrid un día después.)</div><div>4) (adj) physically behind&nbsp;</div>
después de	1) (locative prep) after (Después de comer salimos a pasear.)<div>2) (locative prep) next to / after (Venecia es la ciudad más linda después de París.)</div>
reinar	1) to reign/to rule (El viejo rey reinó cincuenta años antes de abdicar en su hijo.)<div>2) (figurative) to reign/to dominate/to have control over (Federer reinó en el tenis mundial hasta que llegó Nadal.) (En el país reina el caos y no se ve una solución a corto plazo.)</div>
detrás	1) (prep) behind (El niño está escondido detrás del árbol.)<div>2) (prep) at the back</div><div>3) (adv) behind (El hombre que estaba detrás de mí en la fila quería que le cediera mi lugar.)</div>
la barra	1) the bar (the stick) (Le golpearon con una barra de hierro.)<div>2) the bar (the counter) (Juan no sirve en las mesas, está detrás de la barra.)</div><div>3) the vertical bar/pipe symbol (|) (Usa una barra para separar los números.)</div><div>4) the forward slash (/) ()</div><div>5) the rail/the railing (El público saltó la barra para subir al escenario.)</div><div>6) the stribe/bar (cloth insignia) (Los comandantes llevan cuatro barras en las mangas.)</div>
el cubata	1) rum and coke (Te invito a un cubata.)<div><br /></div><div>also: el cubalibre</div>
invitar	1) to invite (Mis amigos nos invitaron a comer.)<div>2) to treat to [something] (A esta ronda invito yo.)</div>
el balcón&nbsp;	"1) the balcony (Salí al balcón a respirar el aire de la noche y vi a dos asaltantes que corrían a toda prisa.)<div><br /></div><div>NOTE: have also seen spelled ""el balcó""</div>"
el ojo	"1) (lit and figurative) the eye /&nbsp;the iris (No ve bien por el ojo derecho.) (Mi hermano nació con heterocronmía, tiene un ojo vere y el otro azul.)<div>2) the care / the caution (Hay que poner mucho ojo en la educación de los hijos para que al crecer sean hombres bien.) (Ojo! Está muy resbaladizo.)</div><div>3) the keyhole / the peephole (La espiaba por el ojo de la cerradura.)</div><div>4) the intuition / the knack (""He has an eye for gold"")<br /></div>"
el gato	"could be ""la gata""<div>1) the cat / the feline (Existe la creencia popular de que un gato siempre aterriza sobre sus patas.)</div><div>2) the (vehicle) jack) (Sacó el gato del maletero del coche para cambiar una rueda.)</div><div>3) tick-tack-toe (Al juego gato se le conoce también como tres en raya.)</div><div>4) the servant / the slave / the lackey (No tengo por qué obedecerte, no soy tu gato.)</div><div>5) the person from Madrid (La proeza de un soldado madrileño al trepar por una muralla podría ser la causa de que, a los nacidos en Madrid, se les llame ""gatos"".)</div>"
el dormitorio	1) the bedroom (Amueblaron el dormitorio con una cama y una cómoda.) (Compraron un dormitorio de caoba.)<div>2) the dormitory (Los estudiantes vien en el dormitorio dentro de la universidad.)</div>
conocer	1) to know / to be aquanted with (El herrero conoce bien su oficio.) (Conozco a tu padre desde hace conco años: es mi abogado.) (Antes de juzgarme tendrías que conocerme.) (Aquella noche la conocí. &nbsp;Antes no la había visto en mi vida.)<div><br /></div><div>2) to recognize / to distinguish (among others) (Sabía que eras tú porque te conocí por el vestido.)</div><div><br /></div><div>present indicative: yo conozco</div><div>present subjunctive: conozc-</div><div>affirmative command: usted conozca / nosotros conozcamos / ustedes conozcan</div><div>negative ocmmand: no conozc-</div><div><br /></div>
cantar	1) to sing (human or animal) (En México se acustumbra contar Las Mañanitas en las fiestas de cumpleaños.)<div>2) to stink / to smell (No veas cómo le cantan los pies a mi hijo!)</div><div>3) to confess (El ladrón delató a sus cómplices; empezó a cantar en cuanto fue capturado.)</div>
el secreto	1) the secret (La localización de la base militar se guarda en secreto.) (La identidad del espía debe ser un secreto.) (Me contó un secreto al oído.) (Se casaron en secreto y nadie se enteró.) (En sus viajes aprendió los secretos de la construcción de catedrales.)<div>2) the special cut of pork (El secretro ibérico es una carne muy rica y apreciada.)</div>
la noche	1) the night (Cuando el día termina comienza la noche.)<div>2) the melacncholy / darkness (Estaba sumido en una noche absimal desde la muerte de su esposa.)</div>
ese	"<div>feminine: esa</div><div>1) (adj) that (Coge ese teléfono, el otro está estropeado.)</div><div>2) the letter 's' (Dibujó una ""ese"" bien grande en la puerta.)</div>"
el repertorio	1) the repertoire (Es un intérprete con un amplio repertorio.) &nbsp;<div>2) the catalog (Revisaré el repertorio para saber donde puedo encontrar más información sobre estas pinturas.)</div>
el cliente	<div>feminine: la clienta</div>1) the customer / the client / the guest (La gasonlinera estaba llena de clientes esperando para llenar los depósitos de sus coches.)
el bar	1) the bar / the pub (Ir al bar del barrio a tomarse una copa al salir trabajo es un ritual para mi esposo.)<div>2) measure of pressure (bar) (Bar es el nombre del baro en la termilogía internacional y es una unidad de presión muy usada en meteorología.)</div>
cerrar	1) to close / to shut / to cover [something physical] (La vecina siempre cierra las cortinas para que no la vean.) (Cierra la puerta para que no entre el frío.) (Pon las alubias en ese recipiente y ciérralo.)<div>2) to figuratively end or close something (Los sindicatos y la patronal cerraron las negociaciones.)&nbsp;(Los fuegos artificiales cerraron la fiesta.)<br /><div>3) to heal / to close up (La herida cerró muy bien.)</div><div>4) to turn off (No se te olvide cerrar las luces al salir para no gastar electricidad.)&nbsp;(Cierra siempre el grifo mientras te estés lavando los dientes.)</div><div>5) to clench / to tighten (Cerré los puños tan fuerte de la tensión que reventé un vaso.)</div></div><div><br /></div><div>e --&gt; ie</div><div>present ind: yo cierro / tú cierras / ud. cierra / uds. cierran</div><div>present sub: yo cierre / tú cierres / ud.cierre / uds. cierren / vos cierres</div><div>affirm comm: tú cierra / ud. cierre / uds. cierren</div><div>neg comm: tú no cierres / ud. no cierre / uds. no cierren / vos no cierres</div>
el chaval	feminine: la chavala<div>1) the kid (El chaval se protaba mal cuando no estaba su mamá.)</div>
el repente	1) the sudden impulse (A mi perro le dio un repente y me mordió.)
el dedo	1) the finger / the toe (No pongas el dedo en la plancha porque está caliente. Perdió dos dedos mientras cortaba una tabla.)<div>2) the width of a finger (El dedo es una medida de longitud muy popular, equivale a 18 mm.) (Esta falda está un poco larga; hay que recortarle unos cuatro dedos.)</div>
la espalda	1) the back (body) (Me duele la espalda.)<div>2) the backstroke (Es campeón de los 100 metros espalda.)</div><div>3) the back (of a place or thing) (La espalda de la chaqueta es estrecha.)</div>
dibujar	1) to draw / to sketch (En la guardería enseñaron a mi hijo a dibjuar.)<div>2) to describe / to portray (Te voy a dibujar la situación sin omitir detalles.)</div>
dibjuarse	1) to appear / to become visible (El sol comenzó a dibjarse en el firmamento.)
la mano	1) the hand (Tomé al anciano de la mano para ayudarlo a cruzar la calle.)<div>2) the front foot / paw (El perro se rompió la mano derecha al caerse del techo de la casa.)</div><div>3) the coat (of paint/varnish) (Con una mano de barniz la mesa quedará como nueva.)</div><div>4) the ability / the talent (La comida te quedó exquisita, tienes muy buena mano para la cocina.)</div><div>5) the hand of cards (El tahúr perdió todo su dinero en una sola mano de póquer.)</div><div>6) the leader / first player in certain games (En la próxima partida tú eres mano.)</div><div>7) the pal / the mate (Oye mano! Eres mi cuate pero no abuses, págame el dinero que te presté.)</div>
cerrarse	1) to close ranks (El día de la marcha, se cerraron las filas y aminoraron el paso conforme se acercaron a la plaza mayor.)<div>2) to dig in heels / refuse to budge (Cuando empieza a recibir críticas siempre se pone a la defensiva y se cierra al diálogo.)</div><div>3) to become overcast / to cloud over (De pronte el cielo se cerró y empezó a llover.)</div><div>4) to fall (as night) (Diariamente salía de su casa al cerrarse la noche y regresaba al despuntar el alba.)</div><div>5) to fasten (as zipper/buttons) (Ciérrate la camisa que vas demasiado provocativa.)</div><div>6) to close or shut a case or matter ()</div>
corresponder	1) to be appropriate / to be fitting (Los libros que lees no corresponded a tu edad.)<div>2) to be responsible (Le corresponde al conserje fregar las escaleras.)</div><div>3) to belong (El dinero de la cuenta no se toca, corresponde a la universidad de nuestros hijos.)</div><div>4) to love [sb] back / to return love (Ella corresponde a su amor.)***</div><div>5) to respond / to compensate / to reward (La empresa correspondió pagándole con un ascenso.)</div>
corresponderse	1) to match / to correspond (Los datos que noe proporciona no se corresponden con los de su pasaporte.)<div>2) to write to one another (Mi tía y mi madre se corresponden a menudo.)</div><div>3) to be complimentary ()</div>
loco	1) crazy/insane (Juan está loco, debería estar internado.) (Está loco al aceptar esas condiciones de trabajo.) (En Las Vegas pasé el fin de semana más loco de mi vida.)
debajo	1) under/beneath/below (Una pobre anciano vive debajo del puente.)<div><br /></div><div>note: debajo de = locative prep</div>
molestarse	1) to make the effort ()<div>2) to be offended ()</div>
