นาย	Mr.
และ	1) (conj) and (เครื่องจักรทุกชนิดจะต้องมีมนุษย์เป็นผู้ควบคุมและสั่งการใช้งาน)
นาง	1) Mrs.; count unit คน (นางสมหญิงถูกโจรงัดแงะบ้านเมื่อวานนี้)<div>2) the woman/the lady;&nbsp;count unit คน&nbsp;(นางในฝันของเขาต้องเป็นผู้หญิงผมยาว)</div>
เลข	1) mathematics (เด็กผู้ชายส่วนใหญ่มักชอบเรียนเลขมากกว่าวิชาอื่นๆ)<div>2) the number/the numeral/the figure (ชาวตะวันตกไม่ชอบเลข 13 เพราะเป็นเลขที่นำความโชคร้ายมาให้)</div>
เจ้าของ	1) the owner/the proprietor; count unit คน (เขาเป็นเจ้าของกิจการสิ่งทอที่ใหญ่ที่สุดในประเทศไทย)
เจ้า	1) the god/the angel ()<div>2) the royalty/the prince/the lord/the ruler (พ่อขุนศรีอินทราทิตย์เป็นเจ้าผู้ครองเมืองสุโขทัย)</div><div>3) you (pron) (เจ้าลูกกระทิง เจ้ามัวแต่กินนมแม่ของเจ้า)</div>
ที่สี่	the fourth
ซอย	1) the lane (alley); count unit is ซอย; (บ้านนายกรัฐมนตรี ชวน หลีกภัย อยู่ในซอยหมอเหล็ง)<div>2) to slice (mince, divide) (แม่ซอยหัวหอมใส่ในยำวุ้นเส้น)</div>
ภาค	1) the part (section) count unit: ภาค (เรื่องนี้ยังไม่จบง่ายๆ หรอกต้องมีภาคต่อไปอีกแน่นอน)&nbsp;<div>2) the part (region/area/district/quarter) count unit:&nbsp;ภาค (ตอนนี้ไม่ว่าภาคไหนๆ ก็ประสบกับสภาพดินฟ้าอากาศที่แปรปรวน)</div>
ภู	1) the mountain; count unit ลูก (ยิ่งใกล้วันเดินทางเขาก็ยิ่งจินตนาการถึงสีสันของดอกไม้บนภูสูงแถบเหนือสุดของประเทศ))
ภาคภูมิ	1) to be proud of (คนไทยควรภาคภูมิด้วยรัก หวงแหน และช่วยกันธำรงคุณค่าภาษาไทยตามแนวทางที่พึงจะกระทำ)<div>2) (adj) proud of (คนที่จะเป็นนายกรัฐมนตรีได้นั้นจะต้องมีสง่า มีท่าทางภาคภูมิสมกับตำแหน่ง)&nbsp;</div><div>3) (adv) proudly (หลายต่อหลายประเทศได้กล่าวอ้างอย่างภาคภูมิว่าตนเองสามารถจัดระบบการใช้น้ำได้อย่างมีประสิทธิภาพ)</div>
ใจ	1) the heart (ใจของเขาเต้นแรงหลังจากได้ยินข่าวร้ายจากทางบ้าน)<div>2) the mind/the spirit/the disposition (ผู้ที่หน้าตาสดใสย่อมเป็นผลมาจากใจที่บริสุทธิ์ผุดผ่อง)</div>
นัก	1) extremely (very) (&nbsp;ช่วงฤดูหนาวที่เชียงใหม่จะมีอากาศหนาวนัก)<div>2) one skilled ... [verb or noun]</div>
บอก	1) to tell information (avoid using with 'news', that would be 'read', so อันข่าว) (ผมมีอะไรจะบอกเกี่ยวกับทเรียนของวันนี้) (คุณยายบอกอาการให้หมอฟังอย่างละเอียด)<div>2) to describe/indicate (เหตุการณ์นี้เป็นสัญญาณบอกเหตุร้ายแน่แน่เลย)</div><div>3) to advise (อย่าบอกหนังสือสังฆราช)</div><div><br /></div><div><div>พูด (to speak)</div><div>คุย (to talk)</div><div>เล่า (to tell story)</div></div>
ว่า	1) that<div>2) as to</div><div>3) (unconfirmed: to say)</div><div>4) (unconfirmed: to rebuke)</div>
พวก	1) numerical counter for group/party/set/gang/clique (โปรแกรมพวกนี้จะเป็นโปรแกรมการกุศลซึ่งเป็นโปรแกรมที่ประโยชน์ใช้งานได้จริง)<div>2) the group/the community/the party/the gang (ในขณะที่แนวคิดแบบพวกพฤติกรรมนิยมกำลังเข้าแทนที่พวกโครงสร้างในสหรัฐอเมริกา กลุ่มเกสตัลก็เริ่มมีอิทธิพลในเยอรมัน)</div>
พวกเขา	1) they/them (pron) (กลุ่มจิตรกรชาวฝรั่งเศสเคยถูกโจมตีกล่าวหาว่าภาพเขียนของพวกเขาแหกคอกหาศิลปะไม่ได้)
เขา	1) he/she/they (pron); count unit คน (ฉันไม่แน่ใจว่าเขาจะอยู่บ้านตอนบ่ายรึเปล่า)<div>2) the mountain; count unit ลูก (ในที่สุดนักเดินป่าก็ข้ามเขาลูกนั้นสำเร็จ)</div><div>3) the horn; count unit ข้าง, คู่ (กวางแทบจะสูญพันธ์เพราะมนุษย์ล่าเพื่อต้องการเขาอันสวยงามของมัน)</div><div>4) the dove (bird); Count unit: ตัว&nbsp;(ที่บ้านสวนพ่อจะเลี้ยงนกเขาไว้ดูเล่นแก้เหงา)</div>
คน	1) the human, count unit: คน (ในสมัยก่อนคนยังอาศัยอยู่ในถ้ำ และใช้อาวุธง่ายๆ ในการล่าสัตว์)<div>2) numerical counter for people (except monks and royalty) (นักเรียนหลายคนร่วมกันทำกิจกรรมเพื่อสร้างชื่อเสียงให้โรงเรียน)&nbsp;</div><div>3) to stir (mix/blend) (แม่ครัวคนกะทิให้แตกมัน ก่อนจะเอาไปราดผักที่ต้มไว้แล้ว)</div>
ปก	1) the cover/the bookcover (เด็กกำลังขีดเขียนลงบนปกหนังสือ)<div>2) the collar (ครูสวมชุดสีน้ำเงินขับผิวผ่องติดเข็มกลัดเพชรเล็กๆ ที่ปกเสื้อเป็นรูปตัวผึ้ง)</div><div>3) to cover (ปลาส่วนใหญ่มีเกล็ดปกคลุมทั่วทั้งตัวปลา)</div>
ติ	1) to condemn/to blame/to censure/to criticize/to rebuke (verb) (ผู้จัดการติพนักงานที่มาสายในวันนี้)
ปกติ	1) regular/unremarkable (adj) ()
ธรรม	1) doctrine (see also Teaching of Buddha, dharma) (example?)
ธรรมดา	1) plain/normal (adj) ()
สุด	1) the end/the finish<div>2) (adj) last/rearmost</div><div>3) (adv) extremely/utterly</div>
ที่สุด	1) (adj) best/greatest/most/ultimate (ผมเป็นคนที่สุด)
เชื่อเขาเลย	“Believe them/him!”
เลย	1) to pass/to go through (รถเมล์เลยป้ายไปตั้งไกลจนผู้โดยสารต้องเดินกลับมาเอง)<div>2) (adv) really/indeed (การเยียวยารักษาคอมพิวเตอร์ที่ถูกไวรัสเล่นงานนี้ไม่ใช่เรื่องสนุกเลย)</div><div>3) (aux) obliged to/have to (พวกเราพลาดรถโดยสารเที่ยวสุดท้ายเลยต้องเดินกลับ)</div><div>4) (adv) completely (ผมไม่เห็นด้วยเกี่ยวกับเรื่องที่เขาพูดเลย)</div>
เชื่อ	1) to believe in/to have faith in (ชาวไทยเชื่อในพระพุทธศาสนา)<div>2) to believe (something/somemone)</div><div>3) to buy on credit (เราได้ของเหล่านี้มาโดยเชื่อไว้กับร้านไว้ก่อน)</div>
ท้าย	1) the rear/the end (รูปร่างของเขาเล็กและเตี้ย จึงต้องอยู่ท้ายแถวเป็นประจำ)<div>2) the last/the final (นิทานเรื่องนี้ ท้ายเรื่องได้ให้คติสอนใจไว้ด้วย)</div>
สุดท้าย	the last/very last (extremely end/tail?)
คิด	1) to estimate/to speculate/to guess (นักภูมิศาสตร์จากบริษัทสำรวจทางอากาศคิดว่าการใช้คอมพิวเตอร์จะช่วยให้งานนี้สำเร็จได้เร็วขึ้นและประหยัด)<div>2) to create/to make/to invent (คอมพิวเตอร์เป็นเครื่องมือที่มนุษย์ได้ประดิษฐ์คิดขึ้นมาไม่น้อยกว่า 50 ปีแล้ว)</div><div>3) to think/to conceive/to imagine (เขาคิดแบบแปลนบ้านไว้อย่างสวยหรู, Thai definition: ทำให้ปรากฏเป็นรูปหรือประกอบให้เป็นรูปหรือเป็นเรื่องขึ้นในใจ)</div><div>4) to want to/to intend to (เด็กที่อยู่ตามท้องนาก็คงมีจำนวนน้อยที่คิดจะไปเรียนเมืองนอกเมืองนา)</div><div>5) to calculate/to compute/to reckon (นายจ้างจะคิดค่าอาหารและค่าที่พักให้ลูกจ้างโดยเรียกเก็บจากลูกจ้างภายหลัง)</div><div>6) to consider/to reflect/to contemplate (ผมพยายามคิดหาเหตุผลที่เหมาะสมกับการกระทำของเขาในครั้งนี้)</div>
ถึง	1) even though (conj) (ถึงพ่อจะใจดีแค่ไหน ท่านก็คงจะไม่อนุญาตให้เราไปเที่ยวกลางคืน)<div>2) to reach (v) (ทุกคนถึงที่หมายอย่างปลอดภัย)</div><div>3) to (prep) (ผมจะรอตั้งแต่บ่ายโมงถึงสามโมง ถ้าเขายังไม่มาผมก็ยกเลิกสัญญาก็แล้วกัน)</div><div>4) to be skillful (at something) (v) (เขายังไม่สามารถซ่อมตรงจุดนี้ได้เพราะฝีมือยังไม่ถึง)</div><div>5) to be enough (v) (ต้มยำชามนี้รสชาติยังไม่ถึงเครื่องเท่าไหร่)</div><div>6) then (conj) (นั่นสิ ลูกต้องทำอย่างนี้ถึงจะเป็นเด็กดี)</div>
ถึงว่า	that
มี	1) to consist of/to comprise/to include (อาหารหลักที่สำคัญต่อชีวิตเรามี 5 หมู่)<div>2) rich/wealthy (เขาเป็นคนมีคงไม่หันมามองคนจนๆ อย่างเรา)</div><div>3) to have/to own (เขามีสุนัขอยู่ที่บ้านเกือบ 10 ตัวทั้งหมดเป็นพันธุ์ไทยหลังอาน)</div><div>4) it is/they are/there is/there are (ช่วงนี้มีฝนตกชุก ควรเลื่อนการก่อสร้างออกไปก่อน)</div>
อะไร	1) (pron) whatever (ปัจจุบันนี้ในกระทรวงศึกษาธิการ อะไรก็สามารถเกิดขึ้นได้ทั้งนั้น)<div>2) (adv) whatever (ไม่ว่าหล่อนจะขยับตัวทำอะไรก็จะตกเป็นข่าวทั้งสิ้น)</div><div>3) (question) what (การเล่นอินเตอร์เน็ตให้ประโยชน์อะไรกับผู้เล่นบ้าง)</div><div>4) (determiner) any (see also: every) (ไม่ว่ามหาวิทยาลัยจะจัดงานจัดกิจกรรมอะไร ก็มักจะได้เขาเป็นสปอนเซอร์อยู่เสมอ)</div><div>5) something (ผมมีอะไรจะบอก)</div>
เกี่ยว	1) to hook/to seize/to catch (มันใช้ปลายหางของมันเกี่ยวเป็นตะขอหรือดึงอะไรๆ ได้คล้ายมือเวลามันไต่ไปมา)<div>2) to connect/to realte/to invlove (วัตถุประสงค์ของกลุ่มนี้ก็คือแลกเปลี่ยนไอเดียข่าวสารความเห็นที่เกี่ยวกับคอมพิวเตอร์)</div><div>3) to reap/to harvest/to mow (ชาวชนบทที่เข้ามาทำงานในกรุงเทพ จะต้องกลับบ้านไปช่วงระยะเวลาหนึ่งเพื่อไปเกี่ยวข้าวในหน้านา)&nbsp;</div>
ข้อง	1) the fish trap ()
กับ	1) with (prep) (ผมยากคุยกับคุณ) (นักประวัติศาสตร์มีความคิดเห็นขัดแย้งกับความเชื่อเดิม)<div>2) with ('by') (พยานเห็นเหตุการณ์กับตาจึงได้แจ้งตำรวจ)</div><div>3) and (conj) (like with) (แดงกับดำเป็นเพื่อนกัน)</div><div>4) on (prep) (like at) (ทุกวันอาทิตย์ เขาจะอยู่บ้านและนั่งเล่นกับพื้นหญ้า)</div><div>5) the trap/the snare; count unit: (อัน) (เขาวางเหยื่อล่อเพื่อให้หนูมาติดกับ)</div>
ข้องกับ	related to (prep)
เกี่ยวกับ	"1) about (prep) (หนังสือหรือตำราเกี่ยวกับเรื่องคอมพิวเตอร์ที่เป็นภาษาไทยนั้นไม่รู้ว่าจะไปหาอ่านได้ที่ไหน)<div>2) to be about/to concern (การปราศรัยครั้งนี้ไม่เกี่ยวกับพรรคการเมืองไหนทั้งนั้น))</div><div><br /></div><div>NOTE: use with stories and information. &nbsp;use ประมาณ for ""about"" as in ""approximately""</div>"
เรื่อง	1) the story (matte/affair) (ความเจ็บปวดในเรื่องความหิวกระหาย เป็นเรื่องที่ทำให้คนแสดงพฤติกรรมที่เข้าหา)<div>2) the trouble (quarrel/matter/problem) (ลูกชายบ้านนั้นมีเรื่องกับคนอื่นไม่เว้นแต่ละวัน)</div>
แปลก	1) to be strange/to be odd (ผู้ชายคนนี้แปลกจัง ชอบมาวนเวียนอยู่หน้าบ้านฉันทุกวันเลย)<div>2) strange/odd (เมื่อวานมีเรื่องแปลกเกิดขึ้นในหมู่บ้าน)</div>
words with similar meaning next to each other	stresses the meaning/importance and/or make it sound better
ลึกลับ	1) mysterious/esoteric/hidden
ลึก	1) deep (bottomless) (คูเวตมีชัยภูมิประเสริฐ มีท่าเรือน้ำลึกอยู่ตรงปากทางออก)<div>2) to be deep (บ่อน้ำตรงนี้ลึกนะ เด็กๆ อย่าลงไปเล่นตามลำพัง)</div><div>3) (adv) deeply/profoundly (เมื่อคิดไปให้ลึกแล้วจะพบว่ามันไม่ใช่เรื่องง่ายๆ เลย)</div>
ลับ	1) to fade (away) (ผู้ชายคนนี้ไม่เคยลับไปจากความจำของผมเลย)<div>2) to sharpen (whet) (คนสมัยก่อนรู้จักนำหินมาลับให้แหลม นำเหล็กมาตีให้คมใช้เป็นอาวุธ)</div><div>3) (adj) secret (อั้งยี่ซานเหอเป็นสมาคมลับเก่าแก่มาตั้งแต่โบราณ)</div>
เพราะ	1) (adj) melodious (ฉันชอบเพลงนี้ตรงที่มีทำนองเพราะน่าฟัง ไม่ได้ชอบที่ตัวคนร้อง)<div>2) (conj) because ( ี่รัฐบาลตัดสินใจสลายการชุมนุมอย่างรวดเร็ว เพราะหากปล่อยให้ยืดเยื้อย่อมกระทบต่อการลงทุนของต่างชาติ)</div>
วัน	1) the day (ผู้นำฝ่ายค้านคาดว่าแต่ละวันแต่นี้ไปสถานการณ์จะรุนแรงกว่านี้)
เข้า	1) to reach (รถประจำทางจะเข้ามาที่สถานีตรงเวลาทุกวัน)<div>2) to enter (เด็กๆ รีบเข้าไปในบ้านก่อน อย่าให้โดนฝน เดี๋ยวไม่สบาย)</div><div>3) to get along with (เด็กๆ เข้ากับเพื่อนใหม่ได้ดี)</div><div>4) to put in (หลังจากขายสินค้าชิ้นแรกได้ แม่ค้ารีบเก็บเงินเข้ากระเป๋าอย่างรวดเร็ว)</div>
ไป	1) to go (เขาไปกรุงโรม)
เข้าไป	1) to enter (ผู้มาร่วมพิธีเข้าไปในโบสถ์หมดแล้ว)
ยุ่ง	1) (v) to be disheveled/to be tousled/to be messy ()<div>2) (v) to meddle ()</div><div>3) (adj) busy/full/occupied ()</div><div>4) (adj) messy/in disorder/in confusion ()</div><div>5) the barn/the silo/the storehouse ()</div>
ไร้	1) to lack/to be devoid of (จังหวัดที่มีเกษตรกรไร้ที่ดินทำกินมากที่สุดได้แก่จังหวัดสุมทรปราการ)
สาระ	1) the essence ()<div>2) the substance ()</div>
ไร้สาระ	1) (adj) absurd (nonsense/ridiculous) ()<div>2) (adj) crap (worthless/useless) ()</div>
แบบ	1) the mould (สิ่งที่แกะหรือสลักเป็นต้น ให้เป็นรอยลึกลงไปหรือนูนขึ้นมาเพื่อใช้เป็นแม่พิมพ์)<div>2) the model (style/way/form/pattern) (การคลอดแบบโบราณนั้นทำกันที่บ้าน ทำในห้องต่อหน้าสามี)</div>
แบบนั้น	“like that”
เด็ด	1) to pick (pluck off) (ห้ามเด็ดดอกไม้ใบไม้ในสวนสาธารณะ)<div>2) excellent/superb (นักมวยยังไม่ได้ปล่อยหมัดเด็ดของเขา)</div><div>3) (adv) absolutely (ผมไม่เอาเขาเด็ดๆ)</div>
ขาด	1) to be torn/to be ragged/to be worn out (เสื้อเขาขาดเป็นริ้วๆ เพราะโดนคนร้ายเอามีดฟัน)<div>2) to miss/to be absent (สมศักดิ์ขาดโรงเรียนไปหลายวัน เพราะเป็นไข้หวัด)</div><div>3) to lack of/to be short of (โรงงานของเรายังขาดวัตถุดิบที่จะนำมาผลิตสินค้าอีกมาก)</div>
เด็ดขาด	1) to be decisive/resolute/firm (ทหารต้องเด็ดขาด)<div>2)&nbsp;[if at end of sentence] ever/at all [intensifier]; absolutely (เขาตั้งใจจะเลิกสูบบุหรี่โดยเด็ดขาด)</div>
เงิน	1) the money; count unit บาท (ข้อมูลของคุณมีค่ามากกว่าเงินเพียงไม่กี่สิบบาท)&nbsp;<div>2) the silver (บางคนชอบเครื่องประดับที่ทำจากเงิน)</div>
คิดเงิน[ดัวย]	“check please” (lit “think money also/with/by/because”)
ผู้อำนวยการ	1) the director/the chief; count unit: คณ (ตอนนั้นผมทำงานในตำแหน่งผู้อำนวยการโครงการวิจัยภาษาธรรมชาติอยู่ที่ศูนย์ปัญญาประดิษฐ์)
อำนวยการ	1) to direct (manage, give orders) (พระองค์ทรงเป็นทั้งบรรณาธิการและอำนวยการหนังสือพิมพ์ ที่ออกโดยคนไทยฉบับแรกนี้)
บริษัท	1) the company/the corporation/the firm/the agency
กรัน	1) dwarf (small) (เขามีร่างกายเตี้ยและกรัน ดูแล้วไม่ได้ส่วน)<div>2) kind of banana (count unit: ผล, หวี) ()</div>
ซึ่ง	1) which (that/where) (เราต้องการหนังสือซึ่งใช้อ้างอิงได้)
กรันนิงส์	Grunnings, Mr. Dursley’s company
ผลิต	1)&nbsp;to generate (เครื่องทำความร้อนจะผลิตความร้อนออกมาในปริมาณที่พอเหมาะ)<div>2) to manufacture (ประเทศญี่ปุ่นผลิตเครื่องจักรกลออกขายทั่วโลก)</div>
สว่าน	1) the drill (tool); count unit ตัว (ช่างไม้กำลังใช้สว่านเจาะกำแพงเพื่อแขวนตะปู)
เป็น	1) to be (something)<div>2) (adj) alive/existent/living (เขาซื้อปลาเป็นๆ มาทำอาหาร)</div><div>3) to be able to (เรื่องประกอบเครื่องเราไม่ต้องสอนเขา เพราะเขาเป็นอยู่แล้ว)</div>
ตัว	1) (pron) you (ตัวจะไปเที่ยวกับพวกเราไหม)<div>2) numerical classifier for animals and things (ภายในห้องนี้เป็นห้องโล่ง มีเพียงเก้าอี้ 2 ตัว)</div><div>3) the body/the figure/the physique; count unit: ตัว (ผู้ก่อการร้ายเป็นตัวดีในการวางระเบิดเส้นทางรถไฟชายแดนภาคใต้)</div>
ล่ำ	1) muscular (stout/brawny/stalwart/athletic/strong) (ชายร่างล่ำมีหน้าที่พาวัวออกไปกินหญ้า)
ใหญ่	1) (adj) big/large/great/major/important (ขาเป็นเจ้าของปั๊มน้ำมันที่ใหญ่ที่สุดในประเทศไทย)<div>2) to be big/to be large/to be huge (บ้านใหม่ของเขาใหญ่มาก ใช้งบในการสร้างเกือบสิบล้าน)</div>
คอ	1) the popularity (fondness/admiration) (ผมเป็นคอหนังสืออยู่แล้ว เมื่อสิ้นกระบวนการชมจึงต้องแวะเข้าไปอุดหนุนตามธรรมเนียม)<div>2) the neck (การก้มเงยและนั่งอยู่ตลอดเวลาจะทำให้มีอาการของการปวดเมื่อยคอ หลังและแขน) count unit:&nbsp;คอ</div><div>3) the collar (ทุกคนใส่เสื้อคอกว้าง แขนกุดกับกางเกงขาสั้น)&nbsp;</div>
สั้น	short/concise/brief/squat
จน	1) until/till (กายกับจิตมีความสัมพันธ์กันอย่างใกล้ชิดจนไม่อาจแยกออกเป็นอิสระจากกันได้)<div>2) to be poor/to be poverty-stricken (ครอบครัวนี้จนมากไม่มีแม้แต่ที่จะซุกหัวนอน)</div>
เรียก	1) to call (shout, maybe phone) (ผมเรียกจนแสบคอ เธอก็ยังไม่หันมา)
ได้	1) to get/to obtain/to receive (นักท่องเที่ยวได้ข้อมูลนี้จากหนังสือนำเที่ยว)<div>2) (adv) can/to be able to/to be capable of (comes at end) (พนักงานต้อนรับที่นี่พูดภาษาอังกฤษได้)&nbsp;(เด็กจะกินข้าวได้ต่อเมื่อล้างมือเรียบร้อยแล้ว)</div><div>4) (aux verb before principal) [indicate past tense] (ตอนที่ไปเที่ยวเมืองจีน เขาได้ไปเยี่ยมชมกำแพงเมืองจีน)</div>
เทียว	1) to go there and back / to go to and fro (เขาเทียวไปเทียวมาที่บ้านฉัน)<div>2) (adv) absolutely (อย่าไปที่นั่นเทียว)</div><div>3) the pipe-shaped or cylindrical flag (เราจะประดับธงเทียวเวลามีงาน)</div>
ตอน	"1) numerical counter for a section/part/passage/division (หนังสือเล่มนี้แบ่งออกเป็น 2 ตอน ตอนแรกเป็นภาษาไทย ตอนที่สองเป็นภาษาอังกฤษ)<div>2) (prep) period (like ""at"") (เขานึกได้ว่านัดเพื่อนไว้ที่ร้านพิซซ่าแถวลาดพร้าวตอนห้าโมงเย็น)</div><div>3) (conj) when (พ่อกลับมาบ้านตอนฝนตกพอดี)</div><div>4) the part/the portion (ข้อความเชิงอรรถจะปรากฏอยู่ตอนท้ายของย่อหน้าหรืออยู่ที่บรรทัดล่างสุดของหน้ากระดาษแต่ละหน้า)</div><div>5) to castrate (หลังจากแม่สุนัขออกลูกคอกนี้แล้ว เจ้าของจะพามันไปตอน)</div>"
วันจันทย์	Monday
วันอังคาร	Tuesday
วันพุท	Wednesday
วันพฤหัส	Thursday
วันศุกร์	Friday
วันเสวร์	Saturday
วันอาทิตร์	Sunday
วันนี้	Today (จงระลึกว่าวันนี้เป็นวันแห่งการเสียสละของบรรพบุรุษของเรา)
พรุ่งนี้	1) tomorrow (พรุ่งนี้ค่อยไปหาซื้อของกินในเมืองมาเตรียมไว้)
วันนี้วันอะไร	"""What day is today?"" {Day this day what?}"
วันนี้วันที่เท่าไหร่	What is the date? (answer with number only) {Day this day at how much?}
วันนี้[วัน]	Today is [name of day]
วันนี้วันที่[เลข]	"""Today is [day number]"" {Day this day at [number]}"
วันพรุ่งวันอะไร	What day is tomorrow?
วันพรุ่งวันที่เท่าไหร่	What is the date (number) tomorrow?
วันพรุ่งวันที่[เลข]	Tomorrow is the [date number]
เมื่อวานวันอะไร	Yesterday is what day [name]?
เมื่อวาน[วัน]	Yesterday was [day name]
เมื่อวานวันที่เท่าไหร่	Yesterday was what date? (number)
เมื้อวานวันที่[เลข]	Yesterday was the [day number].
ความสุข	1) happiness (หากเราเดินสายกลางไม่ตึงหรือหย่อนเกินไปแล้วชีวิตเราจะมีความสุข)
วันนี้คุณมีความสุขไหม	"""Are you happy today?"" {Day this you have happiness [quesition word]}"
เท่าไหร่	How much/How many? (question about number) (ฉันต้องชดใช้ค่าเสียหายเป็นเงินเท่าไหร่)
"Full ""non-conforming"" consonant cluster tone rule and examples"	<div>In syllables with initial consonant clusters, the overall lexical tone is determined by the consonant class of:</div><div>• the first consonant in the cluster, if the second consonant is a sonorant;&nbsp;(สนุก)</div><div>• the second consonant in the cluster, if the second consonant is not a sonorant. (ทหาร [1) solider]; แสดง [1) to act/to perform/to demonstrate/to show/to display, 2) the acting/the show/the demonstration/the performance, 3) the actress/the actor] เฉพาะ [specific/particular/limited/provisional] แขนง [1) the small branch/the twig/the offshoot, 2) branch of a family of science, 3) numerical classifier for branches and twigs] ไฉน (1) why; wherefore, 2) a type of oboe/flute)</div>
กำ	1) [numerical unit] handful (ดอกไม้ 3 กำใหญ่ๆ ถูกนำมาจัดเป็นช่ออย่างงดงาม)<div>2) to grasp (ครูผู้ฝึกสอนบอกให้เขากำด้ามแร็คเก็ตแน่นๆ)</div><div>3) spokes of a wheel (count unit: ชี่)</div><div>4) linear measure equal to 8 inches</div>
กำลัง	1) circumference of a tree<div>2) the power/the strength/the energy/the force (เขาเป็นคนที่มีร่างกายแข็งแรง จึงทำให้มีพละกำลังมาก)</div><div>3) (aux) being (e.g., in the act of / in the process of) (พจนานุกรมมโนทัศน์กำลังพัฒนาอยู่ที่อีดีอาร์)</div>
ลัง	1) the box/the case/the casket (ภายในลังนั้นเป็นหนังสือชาวกรุงล้วนๆ)<div>2) numerical counter for crate, box, case, chest (เจ้าหน้าที่นำของมาส่ง 5 ลัง)</div><div>3) species of marine fish (short mackerel) (ปลาลังมีครีบฝอยจำนวน 5 ครีบ อยู่ถัดไปทางโคนหาง) (count unit ตัว)</div>
พ่อ	1) the father/the dad (ผลการวิจัยพอสรุปได้ว่าชายได้รับอิทธิพลจากพ่อมากกว่าหญิง)
ต้อง	1) (aux) must/shall/ought to (&nbsp;มนุษย์เราจำเป็นต้องใช้ชีวิตร่วมกับผู้อื่น)<div>2) to touch/to contact (สีรุ้งที่เห็นนั้นมาจากแสงอาทิตย์ที่ส่องต้องเม็ดทราย)</div><div>3) to fall into/hit by (เขาต้องโทษสถานหนักติดคุกตลอดชีวิต)</div>
จะ	1) (aux) will/shall (การอนุรักษ์สิ่งแวดล้อมจะสัมฤทธิ์ผลได้ถ้าทุกคนร่วมมือกัน) synonym จัก&nbsp;
กว้าง	1) (adv) widely (ในการมองชนบทไทยควรจะมองให้กว้าง เพราะเป็นแหล่งชนบทที่สำคัญของโลกที่เราหลงลืมกันไป)<div>2) to be wide (ถนนในหมู่บ้านกว้างมาก)</div><div>3) the width/the extensiveness ()</div>
ผู้	"1) ""one who somethings""/[something]-er (""ผู้อำนวยการ"")"
ดอกไม้	1) baby tooth; count unit () (ฟันของเด็กที่แรกขึ้น) (emmy says not used anymore)<div>2) flower/blossom/bloom; count unit ดอก (ดอกไม้ในกระถางนี้ออกดอกทุกๆ อาทิตย์)</div>
วันพรุ่งนี้[วัน]	Tomorrow is [day name]
เมื่อวาน	yesterday
ways to form compound nouns (and examples)	1) [head noun] + [noun attribute]<div>รถไฟ: train (vehicle + fire)</div><div>ร้านอาหาร: restaurant (shop + food)</div><div>เงินเดือน: salary (money + month)</div><div>ช่างไฟฟ้า: electricition (mechanic + electricity)</div><div>2) [head noun] + [verb (+ object) attribute]</div><div>นำ้แข็ง: ice (water + to be hard)</div><div>บทเรียน: lesson (text + study)</div><div>คำแนะนำ: introduction (word + introduce)</div><div>คนขับรถ: driver (person + to drive + car)</div><div>เคื่รองซักผ้า: washing machine (machine + to wash + clothes)</div>
นัก[verb or noun]	"""one skilled in [verb or noun]""<div>Examples:</div><div>- นักศึกษา student (+ to study)</div><div>- นักเขียน writer (+ to write)</div><div>- นักกีฬา sportsman/athlete (+ sport)</div><div>- นักธุรกิจ businessman (+ business)</div><div>- นักหนังสือพีมพ์ journalist (+ newspaper)</div>"
ผู้[verb or noun, usually verb]	"""one who...""<div>ผู้ใหญ่: adult (+ to be big/to be important)</div><div>ผู้เชี่ยวชาณ: expert (+ to be skilled)</div><div>ผู้ร้าย: crimial (+ to be bad)</div><div>ผู้ชาย: man (+ male)</div><div>ผู้หญิง: woman (+ female)</div>"
ใบ[+verb or sometimes noun]	"<div>""a sheet of paper + [verb or sometimes noun]""</div>ใบรับรอง: the guarantee (+to guarantee)<div>ใบสัญญา: the contract (+to promise)</div><div>ใบอนุญาต: the permit (+to permit)</div><div>ใบขับขี่: the driving license (+to drive)</div><div>ใบเส็จรับเงิน: the receipt (+finish +receive +money</div>"
โรง[noun or verb]	"""a large building [+ noun or verb]""<div>โรงรถ: garage (+car)</div><div>โรงงาน: factory (+ work)</div><div>โรงหนัง: cinema (+ film/movie)</div><div>โรงแรม: hotel (+ to stay overnight)</div><div>โรงเรียน: school (+ to study)</div>"
การ[+ noun] or [+ verb]	"""matters of [noun]"" or ""the act of [verb], in many instances like a gerund""<div>การบ้าน: homework (+house/home)</div><div>การไฟฟ้า: Electricity Authority (+electricity)</div><div>การเงิน: finance (+money)</div><div>การเมือง: politics (+city/country)</div><div>การรักษา: care/preservation (+to care for)</div><div>การสึกษา: education (+to study)</div><div>กานช่วยเหลือ: assistance (+to assist)</div><div>การเดินทาง: travel (+to travel)</div><div>กานกิน: eating (+to eat)</div><div>กานรบ: fighting (+to fight)</div><div>การเรียน: studying (+to study)</div><div>การพูด: speaking (+to speak)</div><div>usually a gerund in this sense ""act of"" is used without ""การ"" in spoken Thai</div>"
ความ[verb]	"""(used to form abstract nouns) + verb""<div>ความรัก: love (+to love)</div><div>ความรู้: knowledge (+ to know)</div><div>ความคิด: idea (+ to think)</div><div>ความสำเร็จ: success (+to complete)</div><div>ความสุข: happiness (+to be happy)</div>"
co-ordinated compounds and examples	- two or more nouns can occur together to make a new noun where the second (and other) nouns do NOT modify the first<div>- often, they involve a four-syllable pattern, with duplication of first and third elements, internal rhyme, alliteration, or insertion of meaningless syllable to preserve rhythm</div><div>พ่อแม่: parents (father - mother)</div><div>พี่น้อง: siblings (older sibling - younger sibling)</div><div>เสื้อผ้า: clothes (upper garmet - lower garment)</div><div>ปู่ย่าตายาย: grandparents (paternal grandfather - paternal grandmother - maternal grandfather - maternal grandmother)</div><div>ชาวไร่ชาวนา: farmers (people - dry rice field - people - wet rice field)</div><div>ชาวเขาชาวดอย: mountain people (people - hill - people - mountain)</div><div>นำพักนำแรง: one's own effort/labour (water - rest - water - energy)</div><div>ครูบาอาจารย์: teacher (teacher - rhyming nonsense syllable - teachers)</div><div>วัดวาอาราม: wats/temples (temple - alliterative/rhyming nonsense syllable - temple buildings)</div>
general classifier rules and examples	<div>noun phrases are nounds accompanied by one or more modifiers</div>1) classifiers are obligatory for noun phrases containing numerals<div>2) uncountable nouns like rice, beer, silk are counted as expected (e.g., bottle, kilo, meter)</div><div>3) every noun is counted by specific classifier</div><div>เพื่อนสองคน: two friends (friend - two - person)</div><div>หมาห้าตัว: five dogs (dog - five - classifier for animals and things)</div><div>หนังสือสิบเลม: ten books (book - ten - classifier for books/knives/swords/etc)</div><div><br /></div>
อัน	1) the piece (slice/flake/part) (ปัญหานี้เป็นปัญหาที่สำคัญที่สุดอันหนึ่งในการออกแบบโปรแกรม)<div>2) classifier for small things ()</div>
บาน	1) to bloom/to open out/to come out (หลังการเก็บเกี่ยว ดอกงิ้วจะบานแดงเต็มทุ่ง)<div>2) delighted (คนยากคนจนที่ด้อยโอกาสทุกคนต่างยิ้มหน้าบาน)</div><div>3) classifier for some flat thing (doors, windows, mirrors) (ขโมยปีนเข้าบ้านโดยทุบทำลายหน้าต่างกระจก 1 บาน แต่ไม่มีทรัพย์สินใดสูญหาย)</div><div>4) excessively (แม่เตรียมของกินไว้บานเลย อย่างกับจะไปอยู่สัก 1 เดือน)</div>
ใบ	1) classifier for fruit, eggs, leaves, containers (cups, bowls) slips of paper, documents, etc.&nbsp;(แม่ซื้อโอ่งใหม่มา 3 ใบเพื่อรองน้ำไว้สำรองใช้)<div>2) the leaf (เด็กๆ มักเอาใบตำลึงมาจุ่มสีแล้วทาบบนกระดาษ จะได้รูปเหมือนกบ)</div>
ฉบับ	1) the copy (issue/edition/version) (เราจะพูดถึงวิธีแก้ปัญหาอีกครั้งหนึ่งในฉบับต่อไป)<div>2) classifir for letters/newspapers/documents/things with versions (บ้านนี้รับหนังสือพิมพ์วันละ 2 ฉบับ, Count unit: ฉบับ)</div>
ชนิด	1) classifier for types/kinds/sorts (of things) (สินค้าราคาจะแพงหรือไม่แพงขึ้นอยู่กับชนิดของวัตถุดิบที่ใช้)
ชิ้น	1) classifiers for pieces (of cake, meat, cloth, work, etc) (ผมมีหมู4ชิ้น) (การขายสินค้าของบริษัทมียอดการส่งสินค้ามากกว่า 2 ล้านชิ้น)<div>2) the piece (slice/flake/part/fragment/segment) (แม่หั่นขนมปังเป็นชิ้นสามเหลี่ยม)</div>
ชุด	1) the group (set/series/collection) (ประธานาธิบดีของจีนมาเยือนไทยตามคำเชิญของรัฐบาลชุดนี้)<div>2) classifier for sets of things (มหาวิทยาลัยเปิดขายใบสมัครชุดละ 150 บาท)</div><div>3) the suit (dress/uniform) (ลูกๆ ชอบใส่ชุดที่แม่ตัดให้)</div>
เชือก	1) classifier for elephants (เขาเลี้ยงช้างไว้หลายเชือก)<div>2) the rope (string/cord) (โคบาลใช้เชือกผูกม้าเอาไว้ใต้ต้นไม้)</div>
ดอก	1) classifier for flowers/keys (เขาซื้อดอกกุหลาบมาให้ฉัน 3 ดอก)<div>2) the decorative/floral pattern (คืนนี้เธอใส่ชุดนอนยาวลายดอกเล็กๆ ที่ข้าพเจ้าเคยชมว่าสวยเป็นพิเศษ)</div><div>3) the flower; count unit ดอก&nbsp;(ดอกไม้กำลังออกดอกสะพรั่ง)</div><div>4) the interest ? (เงินเดือนหักหนี้หักดอกแล้วเหลือหมื่นเศษนิดหน่อย)</div><div>4) (interj) unquestionable/certainly ()</div>
ฟอง	1) classifier for eggs (งูเห่าจะออกลูกมาเป็นไข่ครั้งละหลายๆ ฟองอยู่ในรูหรือโพลง)<div>2) the bubble (blowing bubbles) ( ีถ้าเอียงแก้วหน่อยๆ จะช่วยไม่ให้มีฟองมากเกินไป)</div>
แห่ง	1) the place/the location/the spot/the venue (syn thii) (พื้นที่ป่าแห่งนี้มีวัตถุประสงค์มุ่งที่จะจัดทำให้เป็นที่อยู่อาศัยของสัตว์ป่าโดยตรง)<div>2) classifier for places ()</div>
ห่อ	1) to wrap/to package/to envelop (สิ่งของที่จะส่งทางไปรษณีย์ต้องห่อให้เรียบร้อย)<div>2) classifier for packages/parcels/packets (แม่ไปตลาด เพื่อซื้อกะปิ น้ำปลาและยาแก้ปวดสองสามห่อ)</div>
ห้อง	1) the room ()<div>2) classifier for rooms ()</div>
ขบวน	1) the procession (line) (ขบวนของนักเรียนเดินออกจากโรงเรียนอย่างเป็นระเบียบเรียบร้อย)<div>2) classifier for trains and processions (e.g., parades) ()</div>
คัน	1) the stick (bow/rod/long handle) (นำธนูมาเจาะรูให้เป็นสี่เหลี่ยมกึ่งกลางคันให้พอดีกับเดือยสี่เหลี่ยมที่ยื่นออกมา)<div>2) the ridge (อาจารย์ทำคันมากั้นน้ำตรงนั้น)</div><div>3) to itch (ไฮโดรคาร์บอนทำให้ระคายเคืองนัยน์ตาและคันตามผิวหนัง)</div><div>4)&nbsp;Amesiodendron sinensis (plant)</div><div>5) classifier for vehicles, spoons, forks ()</div>
ข้อ	1) the item (provision/clause/point)<div>2) the item (joint? ell?) ()</div><div>3) classifier for items/clauses/points (e.g., in a contract or formal statement) ()</div>
คู่	1) the pair (คู่ของรองเท้าสีดำนี้หายไป)<div>2) (adj) even (การตรวจสอบความผิดพลาดพาริตีมีอยู่สองแบบคือแบบคู่และแบบคี่)</div><div>3) classifier for a pair (กระดูกลำตัวประกอบด้วยกระดูกสันหลัง กระดูกอก กระดูกซี่โครง 12 คู่)</div><div>4) to match/to be paired with (แม่น้ำเจ้าพระยาฝั่งตะวันออกมีวัดสง่างามคู่วังหลวงแห่งองค์พระมหากษัตริย์)</div><div>5) a couple (spouses) (สามีภรรยาคู่นี้เป็นคู่ที่เหมาะสมกันมาก)</div>
เครื่อง	1) the tool (instrument/apparatus/appliance) (มนุษย์สามารถทำให้คอมพิวเตอร์เป็นเครื่องช่วยแก้ปัญญาได้หลายรูปแบบ)<div>2) the thing (article/matter) ()</div><div>3) the machinery; count unit เครื่อง (เครื่องของรถคันสีขาวไม่ค่อยดีเท่าไรควรนำไปซ่อมบำรุงได้แล้ว)</div><div>4) numerical classifier for telephones/TVs/radios/computers/etc ()</div>
ลำ	1) classifier for long, slender, tapering objects (and boats/airplanes?) (กรมศุลกากรสามารถจับกุมเรือน้ำมันเถื่อนในฝั่งทะเลอันดามันได้ถึง 7 ลำ)<div>2) the trunk (body/stalk) ()</div>
หลัง	1) (adv) behind (มีคนพูดซุบซิบกันอยู่หลังหน้าต่าง)<div>2) classifier for dwellings/houses (แบบสถาปัตยกรรมของอาคารแต่ละหลังในกรุงเทพฯ เปลี่ยนไปตามยุคสมัย)</div><div>3) (adj) next (after/later) (คราวหลังอย่ามาสายอีกนะ)</div><div>4) the back (of body) (เด็กชายสองคนกำลังหาบน้ำจนหลังโก่ง เดินตุปัดตุเป๋ตรงมาที่บ้าน)</div><div>5) (adv) after (past, ant: ก่อน) (หลังสงครามโลกครั้งที่หนึ่ง อิตาลีมีแต่ความเสื่อมทราม ทั้งทางการเมือง เศรษฐกิจ และสังคมล้าหลัง)</div>
เล่ม	1) classifier for books/knives/swords/etc (ซีดีรอมเพียงสองแผ่นจะบรรจุรายการหนังสือได้มากว่าหนึ่งล้านเล่ม)
หลอด	1) the straw (drinking) (หล่อนยกแก้วชาดำเย็นขึ้นดูดน้ำหวานจากหลอด)<div>2) classifier for light bulbs, tubes (e.g., toothpaste, straws) ()</div>
ลูก	1) classifier for fruits, balls, mountain ranges (ฝรั่ง 1 ก.ก. จะมีประมาณ 3 ลูก)<div>2) the child/the kid (ความแออัดยัดเยียดทำให้เธอกับสามี และลูกๆ ทะเลาะเบาะแว้งกันอยู่เสมอ)</div>
เม็ด	1) the seed (grain (of sand)) (นิ้วมือของคุณหญิงประดับด้วยเพชรเม็ดเขื่องแสนแวววาว)<div>2) classifier for seeds/grains/pills/buttons (สร้อยเส้นนี้ประกอบด้วยเพชรกว่า 10 เม็ด)</div><div>3) the chessman</div>
มวน	1) the orange bug ? ()<div>2) to roll (a cigarette) (ลุงคล้อยลุกมานั่งขวางประตูรับลม เอากล่องยาสูบมามวนบูหรี่สูบ)</div><div>3) to be colicky (uncontrolled lots of crying) (พอรับประทานน้ำมันละหุ่งเข้าไป ผมก็รู้สึกมวนท้องขึ้นมาทันที)</div><div>4) numerical classifier for a roll (like cigarettes) (บุหรี่สักมวน เหล้าสักแก้ว ผมไม่เคยเห็นเขากิน)</div>
ต้องการ	1) to require (want/need/request/demand) (การที่ผู้โดยสารยอมจ่ายเงินค่าโดยสารเพิ่มขึ้นเป็นเพราะพวกเขาต้องการความสะดวกสบายในการเดินทาง)
อ้างอิง	1) referable (quotable/consultative) (ข้อมูลทั้งหมดถูกเก็บไว้ในรูปตารางอ้างอิง)<div>2) to refer/to cite/to quote (ผู้ทำนายจะต้องสามารถอ้างอิงสิ่งต่างๆ ที่เปลี่ยนแปลงไปตามเวลาได้)</div>
มาสาย	1) to come late ()
สาย	"1) the string/the thread/the wire<div>2) the line/the route</div><div>3) classifier for roads/canals/waterways/belts/necklaces/ropes</div><div>4) late (""as in you came late!"")</div>"
ใคร	1) who (who did it?)
อย่างไร	1) how?<div>2) often changes to ยังไง when talk fast</div>
ที่ไหน	1) where?<div>2) for short: ไหน</div><div>3) also: which (which one, which person) (อันไหน, คนไหน)</div>
ทำไม	1) why?
ห้องนำ้อยู่ที่ไหน	"""where is the bathroom?"""
อยู่	1) to be (somewhere)<div>2) to be on figuratively (e.g., phone) (ผมกำลังคุยโทรศัพท์อยู่)</div><div>3) to lodge/stay somewhere</div><div>4) to be alive/living</div>
รึเปล่า	"1) question word for where you have no information about the answer (คุณเป็นคนอเมริกันรึเปล่า) (""are you an american?"")<div><br /></div><div>NOTE: very similar to ไหม</div>"
ไหม	"1) used to ask a question where you have little information about the answer (คุณชอบอาหารไทยไหม) (do you like thai food?)<div><div><br /></div><div>NOTE: very similar to รึเปล่า.</div><div>NOTE: colloquial versions are มะ and ปะ</div><div>NOTE nouns: &nbsp;can NOT use if the answer is ""to be [a noun]"". &nbsp;use รึเปล่า instead. &nbsp;for example: คุณเป็นครูรึเปล่า (are you a&nbsp;teacher?)</div><div>NOTE : CANNOT use if negative particle (ไม่) in question. &nbsp;use หรอ instead. &nbsp;example: คุนไม่ชอบอหารไทยหรอ</div></div>"
หรอ	"1) question word for negative particles (คุณไม่ใช่คนอเมริกันหรอ) (คุณไม่หิวหรอ)<div><div>2) not restricted to only negative questions:&nbsp;</div><div>examples: can use for ""asking for confirmation"" questions. &nbsp;used this way, it is very similar to ใช่ไหม, but with หรอ you have hard evidence, whereas with ใช่ไหม you are just confirming. &nbsp;(you see a friend walking with a new, girl, later ask คุณมีแฟนไหม่แล้วหรอ; have thai food with friend, friend is sweating a lot and not enjoying it, so เผ็ดหรอ)</div><div><br /></div><div><br /></div></div>"
ใช่ไหม	"1) confirmation question word (without evidence). &nbsp;(""..., right?"", ""..., aren't you/isn't it?""). Examples:<div>คุณเป็นคนไทยใช่ไหม</div><div><br /></div><div>NOTE: similar to / can also use ใช่รึเปล่า (lit. 'is/yes or not')</div>"
มะ	1) colloquial version of ไหม<div>NOTE: very similar to ปะ</div><div>Ex: เธอชอบเขามะ</div>
ปะ	1) colloquial version of ไหม. very similar to มะ<div>(question word with little info about answer)</div><div>Ex: เธอชอบเขาปะ</div>
หรือ	<div>1) (conj) or ()</div>2) very formal question word<div>Less formal: หรอ</div><div>Even less formal: อ๋อ</div><div>เขาชอบแกหรือ</div>
อ๋อ	1) very informal question particle for asking confirmation with hard evidence / negative particles. &nbsp;Ex:<div>(you see him talking to your friend: เขาชอบแกอ๋อ)</div>
how to answer a question	"answer with the important information the asker wants to find out.<div>Ex</div><div>Q: ""คุณชอบอาหารไทย""&nbsp;</div><div>A: ""ชอบครับ""</div><div><br /></div><div>Q: ""คุนพูดภาษาไทยได้รึเปล่า""</div><div>A: ""ไม่ได้ครับ""</div><div><br /></div><div>2) if question uses หรอ (which is asking for confirmation with hard evidence) you can just say ครับ for confirmation</div><div><br /></div><div>3) if question uses ใช่ไหม, you say ใช่ครับ or ไม่ใช่ครับ</div>"
เปล่า	1) no/not (synonym: ไม่) (นักเรียนพูดกับครูว่า ผมเปล่าลอกข้อสอบนะครับ)<div>2) (adj) bare/naked/nude (สมัยผมเด็กๆ ผมเดินไปโรงเรียนด้วยเท้าเปล่าเป็นประจำ)</div><div>3) (adj) empty/blank (ตำรวจจับผู้เสพยาพร้อมของกลางอันได้แก่ขวดเปล่าที่บรรจุ ยาเค และ ยาเลิฟ มากกว่า 40 ขวด)</div>
นะ	1) particle used at end of clause (เย็นนี้อย่าลืมไปงานเลี้ยงให้ได้นะ)
เพลง	1) the song/the musical composition (ผมชอบฟังเพลงนะครับ)
ฟัง	1) to obey/to comply with (เธอฟังผู้ใหญ่ไว้บ้างก็ดี ยังไงเขาก็ผ่านมาก่อนเรา)<div>2) to listen/to hear (พวกเธอฟังที่วิทยากรเขาพูดหรือเปล่า มัวแต่คุยกันอยู่นั่น)</div>
รู้	"1) to know (information) (ผมรู้ว่าไรอันชอบอาหารเผ็ด)<div><br /></div><div>NOTES:&nbsp;</div><div>- usually use ""ว่า"" after. &nbsp;means ""know that...""</div><div>- in contrast to รู้จัก which means ""know someone/someplace""</div>"
เผ็ด	1) (adj) spicy/hot/pungent (like with chilis) (เขาไม่ชอบอาหารรสเผ็ด)<div>2) (v) to be hot/to be spicy/to be pungent ()</div>
รส	1) the flavor/the taste; count unit &nbsp;(คนอังกฤษดื่มเบียร์รสจืด ต่างกับคนไทยที่ชอบรสเยอรมัน) (หูกวีอย่างท่านจันทร์นั้น ท่านฟังรวมรสหมด)<div>2) the Ministry of Labour and Social Welfare (???)</div>
รู้จัก	"1) to know (someone or someplace) (คุณยังไม่รู้จักเขาดีพอ)<div><br /></div><div>NOTE:</div><div>- do not use to mean ""know some information"" (e.g., knowing the date / knowing someone likes apples) -- use รู้ (with ว่า)</div>"
เอา	1) to want (when placing an order) (ผมเอาข้าวผัดไก่) ([if eating something, offering to a friend: คุณเอาไหม)
นำ้เปล่า	1) the plain water / the drinking water (ผมเอานำ้เปล่าครับ)
ขอ	"1) to beg/to ask for (ผมขอไปได้ไหม)<div>2) the hook; count unit เล่ม, ตัว, อัน&nbsp;(เขาค่อยๆ เคลื่อนตัวลงสู่ผิวน้ำพร้อมกับมือซ้ายถือขอแน่น) (เด็กที่น่าสงสารมาขอเงินไปซื้อยาให้แม่)</div><div><br /></div><div>NOTE:</div><div>- use if asking ""can i do something?"" this construction: ผมขอไปได้ไหม</div><div>- do not need ""มี"" if asking for something (ผมขอรหัสวายฟายได้ไหมครับ))</div>"
ช่วย	"1) to help/to assist (คุณช่วยเรียนได้ไหม)<div><br /></div><div>NOTE: use when asking someone else to do something, with ""can"" at the end</div>"
รหัด	1) the code ()<div><br /></div><div>related:</div><div>- รหัสผ่าน (password)</div><div>- รหัสลับ (secret code)</div>
รหัสผ่าน	1) password (การใช้งานเครื่องพิมพ์นั้น ต้องใช้รหัสผ่านก่อน ซึ่งจะถูกควบคุมและจัดการ โดยผู้จัดการสำนักงาน)
ทำ	1) to do (เขาชอบทำการฝีมือประเภทแกะสลักผัก ผลไม้<div>2) to make (ไรอันชอบทำขนม) (เขามีความสามารถด้านแกะสลัก เขาจึงคิดทำเก้าอี้ที่ต้องอาศัยการแกะสลัก)<div><div>3) to observe (ประชาชนทุกคนมีหน้าที่ทำตามกฎหมาย)</div><div>3) to act (เขาชอบร้องรำทำเพลง เมื่อพบเจอเพื่อนฝูง)</div><div>4) to have plastic surgery (ปัจจุบันการเสริมความงามต้องคำนึงถึงความปลอดภัยให้มากขึ้น เช่น ทำนัยน์ตา ทำจมูก)</div><div>5) to commit (ที่เด็กๆ ต้องเจ็บตัวแบบนี้เพราะเขาเป็นคนทำ)</div><div>6) to work (พ่อแม่ของเขาทำสวนผลไม้ เพื่อหาเงินส่งเขาเรียน)</div></div></div>
ทำให้	1) to cause/to produce an effect (คุณทำให้ผมมีความสุข) (ดื่มเบียร์ทำให้ผมอ้วน)
ดื่ม	1) to drink/to swallow a liquid (ดื่มเห้ล่าทำให้อ้วน)
อ้วน	1) (v) to be fat<div>2) (adj) fat</div>
กิน	1) to eat (กินฟาสท์ฟูดทำให้อ้วน)<div>2) to use (take/spend) ()</div><div>3) to corrupt (e.g., embezzle) ()</div>
ให้	1) to give/to offer (แม่ให้เงินติดตัว 1,000 บาทเป็นค่ารถและค่ากินอยู่ในกรุงเทพ)<div>2) to permit/to allow (หมอให้เธอลุกจากเตียงได้หลังจากอาการป่วยดีขึ้น)</div><div>3) (aux) 'to' (inifinitive-maker before verb????) ()&nbsp;</div>
อยาก	1) to want [to (verb)] (ผมอยากไปกรุงเทพ)<div><br /></div><div>NOTE: contrasted with อยากให้, which is used when you want someone ELSE to do something</div>
อยากให้	1) to want [someone else to do something]<div>usage: อยากให้ + [someone else] + verb</div><div>เราอยากให้คุณผูดภาษาไทยทุกวัน</div><div><br /></div><div>NOTE: contrasted with อยาก, which you use when you yourself want to do something</div>
ทุก	1) (determiner) every/each/all (ประชาชนทุกคนควรไปเลือกตั้ง)
อยากได้	1) to want [a thing noun for yourself]<div>lit: to want + to receive</div><div>(เราอยากได้โทรศัพท์ใหม่)</div><div><br /></div><div>NOTE: only used with things. &nbsp;for people, use อยากมี</div>
โทรศัพท์	1) telephone; count unit เคื่อง (หลังจากที่เริ่มมีโทรศัพท์ การติดต่อสื่อสารก็ก้าวหน้าขึ้นเป็นลำดับ)
ใหม่	1) (adj) new/novel/fresh (เขาเป็นคนหนึ่งที่เห่อดาราภาพยนตร์คนใหม่)<div>2) (adv) again/afresh/once more (หลังสงครามโลกครั้งที่ 2 การกีดกันทางการค้านี้ได้เริ่มขึ้นใหม่อีกและได้ขยายตัวทวีความรุนแรงขึ้นเรื่อยๆ)</div><div>3) (adv) newly/recently/anew (บ้านนี้เพิ่งทาสีใหม่ๆ)</div>
อยากมี	1) to want to have [a person, not a thing]<div>(ผมอยากมีแฟน)</div><div><br /></div><div>NOTE: to want to receive things, use อยากได้</div>
ก็	1) (adj) also / likewise (ญี่ปุ่นก็เป็นอีกชาติหนึ่งที่กำลังทุ่มเททางด้านคอมพิวเตอร์เป็นอย่างมาก)<div>2) (conj) as a result (พอวิทยากรพูดจบ ทุกคนก็ตบมือให้)</div>
ก็ดี	1) (adv) or (either or / whether or)&nbsp;(เจ้าสวรรค์ก็ดี เทพยดาผู้ครองโลกก็ดี หรือเทพยดาผู้ครองนรกก็ดีในมือถืออาวุธทั้งสิ้น)<div>2) (v) may as well / be not bad (ฉันว่าเสื้อตัวนี้ก็ดีนะ เหมาะกับบุคลิกของเธอ)</div>
วิทยา	1) the knowledge (related: philosophy/science) (การศึกษาเรื่องศาสนาสามารถศึกษาได้ทั้งแนววิทยาศาสตร์ และแนวแห่งความเชื่อเกี่ยวกับหลักทางปรัชญา)<div><br /></div><div>related: วิทยากร (expert)</div>
วิทยากร	1) the expert (มีคนโทรเข้ามาคุยกับวิทยากรมาก เนื่องจากวิทยากรเป็นคนมีความรู้และพูดได้น่าฟัง)
how to ask to do something?	ผมขอ[something]ได้ไหม
how to ask someone to do something?	คุณช่วย[something]ได้ไหม
พูด	"1) to speak (speak now, do you speak thai, NOT ""he is talking"") (ฉันพูดกับเขาไม่รู้กี่ครั้งต่อกี่ครั้งแล้ว เขาก็ไม่ฟัง) (เราทำงานอยู่ที่เดียวกันแต่ไม่เคยพูดกันสักที) (เขาเรียกประชุมบรรดาบรรณาธิการทั้งหลาย เพื่อพูดถึงปัญหาต่างๆ)<div><br /></div><div>related:</div><div>บอก (to tell information / describe)</div><div>คุย (to talk)</div><div>เล่า (to tell story)</div>"
คุย	1) to talk / to chat / to converse (to someone; on the phone) (ผมคุยโรศพท์) (ผมอยากคุยกับคุณ)<div>2) to brag (ครูห้ามเด็กคุยเสียงดังในห้องเรียน)<br /><div><br /></div><div>related:</div><div>พูด (to speak)</div><div>บอก (to tell information / describe)</div><div>เล่า (to tell story)</div></div>
เล่า	1) to tell a story (recount / narrate) (ท่านนายพลเคยเล่าว่าบ้านเดิมอยู่ในวัดสะตือ จึงมีความผูกพันกับวัดนี้เป็นพิเศษ)<div><br /></div><div>related:</div><div><div>พูด (to speak)</div><div>บอก (to tell information / describe)</div><div>คุย (to talk)</div></div>
ไม่	"1) negation (not) -- used to negate verb or adjective (เราไม่หิว) (เธอไม่ชอบอาหารเผ็ด)<div><br /></div><div>NOTE: do not use for ""do not [verb]"" -- use อย่า</div>"
หิว	1) to be hungry (กลางวันนี่ผมไม่ค่อยกินอะไรเท่าไร หิวเมื่อไรก็กิน)
อย่า	1) do not [verb] (อย่านอนดึก)<div><br /></div><div>contrasted with ไม่ (negate verb or noun)</div>
เหล้า	1) the alcohol / the booze (อย่ากินเห้าเยอะ)
นอน	1) to sleep (คุณพ่อนอนอยู่ในห้องนี้)
เยอะ	1) (adv) much (อย่ากินข้าวเยอะ)<div>2) (adv) many ()&nbsp;</div>
ประมาณ	1) (adv) about (approximately) (ราคาประมาณสองร้อยบาท) (มีผู้เสนอตัวจะลงชิงชัยตำแหน่งประธานาธิบดีประมาณ 12 คน)<div>2) to estimate/to approximate (ในการทำอาหารบางครั้งก็ไม่มีสูตรอะไรที่แน่นอนตายตัว จะต้องประมาณประมาณอัตราส่วนของส่วนผสมเอาเอง)</div>
ข่าว	1) the news; count unit ข่าว, ชิ้น (ผมจะบอกข่าวเกียวกับประเทศไทย) (ปัจจุบันมีข่าวอาชาญากรรมตามหน้าหนังสือพิมพ์มากขึ้นทุกวัน)<div>2) the information; count unit เรื่อง, ประเด็น&nbsp;(ผู้เห็นเหตุการณ์ต้องการให้ข่าวเรื่องการโจรกรรมธนาคารแก่ตำรวจ)</div>
ประเทศ	1) country; count unit ประเทศ (เธอยอมเดินทางกลับประเทศเพื่อสู้คดีต่างๆ)
ราคา	1) the price (ธนาคารอาคารสงเคราะห์ประเมินราคาที่ดินไว้ตารางละ 5,600 บาท)
วิทยุ	1) the radio; count unit เครื่อง (เมื่อภรรยาของข้าพเจ้าทราบข่าวจากวิทยุและหนังสือพิมพ์ เธอก็เป็นลมแล้วฟื้นอยู่หลายครั้ง)
ยิน	1) to become aware of / to perceive by the ear ()
ได้ยิน	1) to hear (ฉันได้ยินเสียงฟ้าร้อง) (คุณได้ยินผมได้ไหม / ได้ยินไหม) (ได้ยินข่าว)
ฟ้าร้อง	1) the thunder (คนป่าดั้งเดิมกลัวฟ้าร้อง ความมืด และสิ่งต่างๆ ที่อยู่เหนือความเข้าใจ)<div>2) to thunder ()</div>
เสียง	1) the voice (related: opinion/view) (เรื่องนี้ฉันขอไม่ออกเสียง)<div>2) the vote (related: ballot) (เขาชนะเพราะได้เสียงข้างมาก)</div>
เค้า	1) her (คุณบอกเค้ารึยัง)<div>2) the sign/the indication (เย็นนี้อย่าออกไปข้างนอกเลย ดูสิเริ่มมีเค้าว่าฝนจะตกอีกแล้ว)</div><div>3) the outline (เค้ามูลของเรื่องนี้เกิดจากความแค้นที่มีมาตั้งแต่สมัยบรรพบุรุษ)</div>
รึยัง	1) yet (question) (คุณกินข้าวรึยัง)
นิทาน	1) the tale/the fable (story) (ผมอยากให้คุณเล่านิทาน
อ่าน	1) to read (นอนาคต เราคงจะมีโอกาสได้เห็นหุ่นยนต์ที่พูด อ่าน เขียนและคิด ได้เฉกเช่นมนุษย์)<div><br /></div><div>used in to read the news</div>
เหนื่อย	1) to be tired/to be fatigued (หุ่นยนต์ไม่เหมือนคนมันไม่รู้จักเหนื่อย และไม่รู้จักเบื่อ)
เหมือน	1) to resemble / to be like<div>2) (adj) same/like/similar</div>
word order for 'will not [verb]'	same as english<div>จะไม่[verb]</div><div>ไรอันจะไม่ทน</div><div>ผมจะไม่ไปที่ประเทศเนปาล</div>
ทน	1) to be durable/to be strong (ไม้สักทนกว่าไม้ยาง)<div>2) endure/tolerate (คนเราต้องทนต่อสภาพสังคมที่เกิดขึ้น)</div><div><br /></div><div>(i will not take it!) &nbsp;endure it</div>
เอง	1) (adv) alone (do it by self/alone) (ผมทำอาหารเอง) (ผมขับรถเอง) (พ่อแม่มักจะไม่ค่อยปล่อยให้ลูกๆ อยู่บ้านกันเองตามลำพัง)<div>2) (adv) only (solely) (เราเพิ่งจะเริ่มใช้ซีดีรอมกันในช่วง 4 - 5 ปี ที่ผ่านมานี้เอง)</div>
ตัวเอง	"1) oneself/myself/yourself (ขาไม่เชื่อหูว่าตัวเองถูกรางวัลที่ 1)<div><br /></div><div>NOTE:</div><div>use to indicate personhood / reflexiveness. &nbsp;do not add to say ""i do it myself"" -- use 'เอง' added at end instead</div>"
คนเดียว	"1) (adv) alone (ผมไม่ชอบกินข้าวคนเดียว) (เขาทำงานชิ้นนี้คนเดียวเลยทำเสร็จช้ามาก)<div><br /></div><div>NOTE:</div><div>use for '1 person'. &nbsp;do NOT use for ""do something by self with no help."" use เอง for that.</div>"
เดียว	1) only/sole (มีนักบินเพียงคนเดียวที่รอดชีวิต)
ดูแล	1) to take care of / to supervise (ดูแลตัวเอง)
หลง	1) to be misled (เธอหลงเข้าใจว่าเขาชอบเธอเป็นคู่รัก)<div>2) to remain (stay behind) (ควันยังหลงอยู่ในห้องและมีกลิ่นไหม้เล็กน้อย)</div><div>3) to lose one's way (มีศาสตราจารย์ท่านหนึ่งเคยหลงเข้าไปอยู่ในป่าแห่งนี้ หาทางออกไม่ได้)</div><div>4) to be infatuated (คุณหลงตัวเอง)*** (มนุษย์เราต้องไม่หลงอยู่กับสิ่งยั่วยวนใจทั้งหลายโดยการฝึกจิตใจให้เข้มแข็งอยู่เสมอ)</div>
ขับ	1) to drive (คณะปฏิวัติขับรัฐบาลออกแล้วร่างกฎหมายใหม่)<div>2) to drive away (expel) (ถ้าเธอยังขับฉวัดเฉวียนแบบนี้อีก ฉันขอลงดีกว่า)</div>
ชา	1) the tea; count unit ห่อ, ซอง, ถุง (ประเพณีที่ชาวญี่ปุ่นถือว่าเป็นพิธีศักดิ์สิทธิ์คือพิธีชงชา)<div>2) to feel numb (อากาศหนาวจัดจะทำให้แขนและขาชาจนไม่สามารถใช้การได้)</div><div><br /></div><div><br /></div>
ทรรมชาติ	1) the nature (ทามชาติในเนปาลสวยมาก) (เราต้องช่วยกันรักษาธรรมชาติไว้)<div><br /></div><div>NOTE:</div><div>related -- natural, creation</div>
แต่	1) (adv) only/sole (คราวใดที่แม่สั่งให้ซื้อผลไม้ แม่ต้องกำชับว่าให้เลือกแต่ลูกโตๆ)<div>2) but (however/nevertheless/yet) (คนส่วนมากต้องการใช้งานระบบเครือข่ายแต่ต้องไม่ใช่ระบบ LAN) (เรารู้ว่าบุหรี่เป็นของไม่ดีแต่เราก็ยังคงสูบอยู่ทุกวัน)</div><div>3) (prep) ealier (ทุกๆ วันเราต้องออกจากบ้านแต่เช้า)</div>
เมือง	1) the city/the town<div>2) the nation/the state/the principality</div>
หลวง	"1) (adj) public/official (คนขับรถบรรทุกประลองความเร็วกันบนถนนหลวง)<div>2) (adj) royal (วัดบวรนิเวศวิหารเป็นพระอารามหลวงชั้นเอกชนิดราชวรวิหารตั้งอยู่บนถนนพระสุเมรุ บางลำพู)</div><div>3) title of respect shown to elderly relatively while in the Buddhist monkhood (หลวงพี่นุ่งเหลืองห่มเหลืองกำลังเดินอุ้มบาตรมาจวนจะถึงหน้าบ้าน)</div><div>4) (adj) great/big/superior/chief ()<br /><div><br /></div><div>NOTE: can be used to mean ""capital city"" with เมืองหลวง</div></div>"
อากาศ	1) the climate/the weather (กล้วยไม้พันธุ์นี้ชินกับอากาศของประเทศไทย)<div>2) the air (ฝ่ายพันธมิตรได้ทุ่มเทแสนยานุภาพทางอากาศโจมตีอิรักอย่างหนัก) (คนเราจะมีชีวิตอยู่และร่างกายแข็งแรงถ้าได้หายใจเอาอากาศที่บริสุทธิ์ได้กินอาหารพักผ่อนและออกกำลังกาย)</div><div>3) the space (แผนอันใหญ่โตของเขากลายเป็นอากาศธาตุไป)</div>
เพื่อน	1) the friend; count unit คน (เขาเป็นเพื่อนที่คบกันมาเกือบ 20 ปี รู้ไส้รู้พุงกันหมดแล้ว)
เสียงดัง	1) the noise (ขณะที่กำลังนอนหลับอยู่ มีคนมาทำเสียงดัง จนเขาต้องสะดุ้งตื่นขึ้นมาทันที)<div><br /></div><div>(noisy)</div>
แอบ	1) to hide / to conceal / to tuck away (เด็กๆ วิ่งไปแอบเพื่อนอยู่หลังประตู)<div>2) to tuck away</div>
คล้าย	1) to resemble / to be alike (เขาทั้งคู่คล้ายกันมากเหมือนเป็นพี่น้องกัน) (ผู้หญิงสองคนนี้คล้ายๆ กันตรงที่มีมุมมองในการใช้ชีวิตอย่างเดียวกัน)
จีน	1) China (คนจีนคุยเสียงดังมาก) (ปัญญาชนเหล่านี้ได้เป็นแกนกลางของการเคลื่อนไหวเรียกร้องประชาธิปไตยในจีน)
แอบคล้าย	"<div>""half like"" (""kind of like"")</div><div><br /></div>not sure if it is a set phrase&nbsp;or if แอบ is a modifier that lessens what comes next"
ถ่าย	1) to transfer (คนงานถ่ายกระสอบข้าวลงในเรือสินค้า)<div>2) to excrete (วันนี้เขาถ่ายทั้งวัน สงสัยจะท้องเสีย)</div><div>3) to take a picture (also with รูป) (ภาพสวยๆ เหล่านี้ ผมวานให้น้องถ่ายให้)</div>
รูป	1) the body (physique, build, figure) (เราจงอย่ายึดมั่นถือมั่นกับรูป รส กลิ่น เสียง)<div>2) the figure; count unit รูป&nbsp;(ริมขอบของดิสก์จะมีช่องบากเป็นรูปสี่เหลี่ยมผืนผ้าเล็กๆ)</div><div>3) numerical classifier for monk (พ่อนิมนต์พระสงฆ์ 5 รูปมาสวดในงานทำบุญบ้าน)</div><div>4) the photograph ( ี่ไปเที่ยวภูเก็ตกลับมา มีรูปให้พวกเราดูหรือเปล่า)</div>
ภ่ายรูป	1) to take a photograph (ผมถ่ายรูปไปพลาง เงี่ยหูฟังเรื่องที่เขาถกเถียงไปพลาง)
ผม	1) male personal pronoun (I) (ผมกระหายน้ำมาก)<div>2) the hair; count unit เส้น (ผมของเธอยาวสลวยและดกดำ)</div>
เหรอ	1) word used to end yes-no question (เธอใช้เงินหมดแล้วเหรอ ตั้งสองหมื่นบาท)
ฝัน	1) to dream (ฝันดี) (&nbsp;แม้ในฝัน ความตึงเครียดก็ยังเข้าไปรบกวนทำให้ฝันร้ายต้องตื่นตลอดคืน)
ทร-	1) behaves as low-class 's'<div>ทราบ</div><div>หราย</div><div>ทรง</div>
-ร	1) usually pronounced 'n', but in words where there is no immediately preceding written vowel, prounced 'อน'<div>พร</div><div>นคร</div><div>ละคร</div>
-รร	1) pronounce as 'an'<div>สรร</div><div>บรรทุก</div>
-รร-	1) pronounce as 'a' (short)<div>กรรม</div><div>พรรค</div>
many words of indic origin final short vowel...	...is not pronounced<div>ชาติ</div><div>ญาติ</div><div>เหตุ</div>
silenced consonants...	... usually appear in words borrowed from sanskirt, pali, and english, and can appear with&nbsp;์, which silences either the one above or the one above AND the one preceding. &nbsp;but, sometimes there is no&nbsp;์<div>เบียร์</div><div>อาทิตย์</div><div>จันทร์</div><div>สาสตร์</div><div>บัตร</div><div>สมัคร</div>
unwritten vowel in multisyllable word with บร...	... pronounced 'อะ'<div>บริษัท</div><div>บริเวณ</div><div>บริการ</div><div>บริหาร</div><div>บริโภค</div>
monosyllable words with silent vowel...	...vowel pronounced 'o'<div>คน</div><div>ยก</div><div>จบ</div><div>หก</div><div>หมด</div>
multisyllable words with silent vowel not บร...	... pronounced 'a'<div>สบาย</div><div>สถาน</div><div>สภาพ</div><div>สนุก</div><div>ตลก</div>
ยมก	1) the repetition character, which is ๆ.&nbsp;<div>เยอะ</div><div>เยอะๆ</div>
เปยยาลนา้ย	"1) the abbreviation character, which is ฯ<div>most commonly used in what westerners call ""Bangkok""</div><div>กรุงเทพฯ</div>"
the full name of กรุงเทพฯ	กรุงเทพมหานครอมรรัตนโกสินทร์มหินรายุธยามหาดิลกภพนพรัตนราชธานีบูรีรมย์อุดมราชนิเวศมหาสถานอมรพิมานอวตารสถิตสักกทัตติยะวิษณุกรรมประสิทธึ์
เปยยาลใหญ่	1) name of the 'et cetera' symbol, which is&nbsp;ฯลฯ
การันต์	1) the silence mark, which is&nbsp;์
฿	1) thai currency symbol
ฟองมัน	"1) the symbol used to indicate beginning of paragraph, which is ๏, used now mainly for poetic or artistic effect. informally known as ตาไก่ (""bird's eye"")"
พินทุ	can be placed underneath:<div>1) first consonant of an orthographic cononant clster which may in turn be 1) a double-consonant cluser, 2) silent ห (แหฺม /maae rising/), or 3) silent อ.</div><div>2) final sounding consonant of a syllable (แหฺม /maae rising/)</div><div><br /><div>NOTE: archaic. &nbsp;mostly used in dictionaries to disambiguate pronunciation.</div></div>
อังคั่นคู่	1) symbol to indicate end of chapter/episode/verse/section of Thai text, which is&nbsp;๚
โคมูตร	1) symbol used to mark end of big section of text&nbsp;๛
ไม้เอก	1) the '่' tone mark (falling / low / low)
ไม้โท	1) the '้' tone mark (high / falling / falling)
ไม้ตรี	1) the '๊' tone mark ( - / high / - )
ไม้จัตวา	1) the '๋' tone mark ( - / rising / - )
อังคั่นวิสรรชนีย์โคมูตร	1) mark end of entire text&nbsp;๚ะ๛
นิคหิต	1) pali 'nasal' symbol. &nbsp;have only ever seen as part of 'am' (ำ) and and 'eu' (ึ).<div><br /></div><div>From wiki:</div><div>'If nikkhahit occurs before a consonant, then Thai uses a nasal stop of the same class: e.g. สํสฺกฺฤตา [saṃskṛta] is read as สันสกฤตา san-sa-krit-ta (The ส following the nikkhahit is a dental-class consonant, therefore the dental-class nasal stop น is used).'</div><div><br /></div><div>don't quite understand the above right now</div>
